好山一窗足	佳景四时宜
千峰凭栏立	九曲抱城来
还家万里梦	为客五更秋
鹤舞千年树	虹飞百尺桥
秋水才深四五尺	野航恰受二三人
四面八方传捷报	千家万户浴春晖
一径飞红雨	千秋散绿阴
青山横北郭	白水绕东城
碧通一径晴烟润	翠涌千峰宿雨收
两个黄鹂鸣翠柳	一行白鹭上青天
乱石吞落日	平畴交运风
鸡鸣茅店月	人迹板桥霜
五更鼓角声悲壮	三峡星河勤动摇
开卷古今千万事	杜门清浊两三杯
大烹以养	小住为佳
红梅传喜讯	绿柳舞东风
万里河山披锦绣	千秋功业耀光华
七宝栏杆千岁石	九州烟景四时花
生为人杰	死作鬼雄
有山皆图画	无水不文章
新松恨不高千尺	恶竹应须斩万竿
青山有幸埋忠骨	白铁无辜铸佞臣
星垂平野阔	月涌大江流
浓翠万重当栏出	清光一片抱城来
凭将梅柳无双管	吹向江山第一楼
野火烧不尽	春风吹又生
江流石不转	云在意俱迟
风和日丽	人勤地丰
三星在户	五业其昌
百事皆乐	万象更新
民生有幸	国运无疆
云霞呈秀	梅柳生辉
门迎百福	户纳千祥
天开化宇	人在春台
金莺报喜	玉燕迎春
阳光凝大地	春色入人家
年丰人益寿	春早福盈门
迎春接福日	足食丰衣年
江山千古秀	祖国万年春
人随春意泰	事共壮怀成
勤劳能致富	和睦可生财
同修富裕路	共建文明村
山河添秀色	大地沐春晖
好景年年好	新春岁岁新
政通千家福	人和万户春
太平真福贵	春色大文章
春晖盈大地	正气满乾坤
淑气芝兰茂	春风桃李香
三阳临吉地	五福萃华门
国登强盛境	人过富裕年
春明有富贵	风静全家安
花随春意发	福从好运来
庆新春肇事	祝大业终成
人民歌永泰	祖国庆长春
一年春作首	百事德为先
半年飞瑞雪	好景舞春风
岁月随人好	山河照眼明
万里春光美	九州瑞气浓
祖国春如海	人民力胜天
梅花开五福	竹叶报三多
年年歌大有	岁岁颂新康
新风开盛世	春色壮神州
红点桃花嫩	青描柳色新
天开新岁月	人改旧乾坤
四海春光好	九州气象新
人民歌大治	祖国庆长安
党指通天路	民怀报国心
神州臻百福	盛世集千祥
风和催四化	政通喜千家
玉堂浮瑞气	金室耀祥光
共祝升平日	同沾大有年
事业随春长	风光逐日新
普天开景运	大地沐春晖
跨峥嵘岁月	奔锦绣前程
龙飞欣晓日	马到庆丰功
日月光天德	云霞拥地灵
有年皆丽日	无处不春风
云霞出海曙	梅柳渡江春
春风舒冻柳	瑞雪兆丰年
和光生柳叶	春色泛桃花
风助飞雪舞	诗伴落梅吟
青山多画意	春雨润诗情
吟竹诗含翠	画梅笔带香
华文春日丽	瑞色紫云高
神州春浩荡	寰海日光华
普天开远景	大地焕新风
云霞成异彩	梅柳动春风
瑞雪娇梅袅柳	新春美酒佳联
户户金花报喜	家家紫燕迎春
祖国河山似锦	神州大地皆春
四海旌旗映日	五湖战鼓催春
国富星辰耀彩	政清日月生辉
天时地利人和	虎跃龙腾鹏展
风展红旗似画	春来绿水如蓝
祖国山青水秀	中华人杰地灵
年丰人寿福满	柳绿花香春浓
梅报九州春色	旗开一代风流
国富民强盛世	花香日暖新春
傲骨高风亮节	红梅翠竹青松
岁岁三春得意	年年万事开心
冬去山明水秀	春来鸟语花香
喜报英雄门第	春归光荣人家
祖国山河壮美	神州春意盎然
物阜国强民富	天时地利人和
喜看江山如画	展望前程似锦
功业长留天地	光辉永照人间
欢炮声声报喜	红联时时迎春
春暖风和日丽	年丰物阜民欢
新岁新光新景	春风春雨春花
春种千山绿玉	秋收万顷黄金
一院芝兰瑞气	万家杨柳春风
春日人人共乐	江山处处皆春
山碧千峰竞秀	水清百鸟争春
政清星辰放彩	国富日月生辉
虎跃龙骧鹏举	花明柳暗春浓
四季时时胜意	千家事事舒心
大业千帆竞发	明春万象更新
国肇繁荣昌盛	民欣长治久安
共喜阳回大地	同歌春到人间
岁岁风调雨顺	年年物阜民康
劳动创造世界	春天属于人民
大地风光旖旎	神州人物轩昂
铁石梅花气概	山川香草风流
碧海苍山玉宇	春风丽日神州
百花迎春斗艳	群英为国争光
妙手描山绣水	雄心强国富民
细雨无声润物	和风会意迎春
冬尽梅花点点	春回爆竹声声
梅蕊乐开五福	竹风喜报三多
盛世千秋伟业	神州万里春风
笑语欢歌辞旧	华灯爆竹迎新
守法奉公遵纪	尊长爱幼敬贤
芳草满园吐秀	群英遍地生辉
荡荡乾坤不老	昭昭日月生辉
春驻笔花万朵	云描淑景千番
处处春光济美	年年人物风流
春自寒梅报到	年从瑞雪迎来
一刻莫闲岁月	十分珍重年华
雪映一天春碧	云浮四海清晖
万众共迎旭日	九州同庆新春
东风入春化雨	汗水落地生金
桃符春花瑞雪	奋燕布谷春风
望烛挑灯思友	浓意淡茶迎宾
田野风光真好	农家岁月更新
一元二气三阳泰	四时五福六合春
春雨多情醉大地	爆竹知音绽心花
春风放胆采梳柳	夜雨瞒人去润花
春光明媚百花地	祖国富强一统天
全民共饮新春酒	举国同迎大治年
柳眼桃腮舒化日	莺歌燕舞闹春风
日丽神州舞彩凤	霞临华夏飞巨龙
东风送暖千丛绿	旭日光耀万户春
松竹梅岁寒三友	桃李杏春风一家
人逢盛世居栖稳	运际阳春气象新
鸟语花香歌丽日	民康物阜乐尧天
春深碧海腾龙甲	花满瑶池飞风羽
东风已绿南国草	春信才开北岭海
三阳开泰生机发	九天增辉喜气扬
六出飞花千亩喜	一声爆竹万家春
满园桃李争春艳	遍山松柏耐岁寒
玉树暖迎沧海日	珠帘光动锦城春
丽日晴天凭风舞	华年盛世任龙飞
忠厚一生嫌善少	平安二字值钱多
天增岁月人增寿	春满乾坤福满门
青山林茂千重翠	碧野粮丰万簇金
梅红塞北满天彩	柳绿江南遍地春
大地复苏春似锦	人心振奋气如虹
万象更新春光好	一看巨变喜事多
春到千家同致富	福临万户共迎祥
时雨点红桃千树	春风吹绿柳万枝
鹊送喜报风送爽	莺传佳音梅传春
柳绿桃红春万里	天蓝莺丽日长天
枝头喜鹊唱新曲	雪里梅花报早春
花红柳绿千山秀	日暖风和万民欢
年丰人寿福如海	柳暗花明春似潮
花灯灿烂逢盛世	锣鼓喧天颂华年
腊梅吐芳迎红日	绿柳展枝舞春风
美酒千盅辞旧岁	梅花万树迎新春
祖国有天皆丽日	神州无处不春风
楼外春阳鸠唤雨	庭前日暖蝶翻风
花承朝露千葩发	莺感春风百啭鸣
兴邦有策苍生福	报国无私赤子心
文明雨润千枝翠	礼貌风吹万朵红
春花消息寒梅报	芳草萌芽细雨催
风吹杨柳千门绿	雨滋桃杏万户红
天将化日舒清气	室有春风聚太和
同歌华夏兴邦曲	共赋神州治国诗
风和日丽花争笑	水绿山青鸟竞歌
千秋伟业同心铸	四化宏图众手成
庭中有竹春常在	天上无云月更圆
一家欢笑春风暖	四季平安淑景新
红杏枝头春意闹	绿杨烟外晓寒轻
梅带寒香成隔发	酒称腊味入新年
除夕刚饮祝捷酒	新年又看报春花
彩笔传情歌盛世	丹霞达意喧廉风
五福十福全家福	千春万春满堂春
春风掩映千门柳	碧间萦回十里花
万里和风生柳叶	一枝春雪映梅花
日丽风和春浩荡	花香鸟语物昭苏
门对青山财源广	户迎绿水富根深
竹叶金樽辞旧岁	梅花瑞雪报丰年
桃李逢时天下春	芝兰得气一庭秀
染庭碧草来春色	入户清风送好音
兴国气势连天涌	富民潮头逐浪高
春露含嫣泛紫气	野花吐馨迎朝阳
皑皑白雪兆丰年	习习东风焕物华
美酒红灯歌胜利	银筝玉管迎新春
爆竹随心飞笑语	春风得意谱欢歌
千秋大地发春华	万里山河涌春潮
庭前瑞发花光锦	门外鸟鸣春风歌
青山石墨千秋画	绿水无弦万古琴
时雨送来千里绿	春光不让一人闲
天上星光增异彩	人间科技建奇功
五色云中开晓日	万年枝上动春风
花如解语迎人笑	草不知名随意生
鸟语早随阳气发	人心长望春不归
欣逢盛世酌喜酒	好趁早春播幸福
莫待明年花更好	当惜今朝春更浓
日丽远山含淑气	风和芳树蔼春晖
大地有色皆春染	人间无处不东风
红气满林花著雨	翠光摇户柳含烟
十亿人民颂大治	万里江山展宏图
举目看花花满目	出门见喜喜盈门
桃花已发三层浪	春潮长吐万里云
鸟韵入帘时正年	花香浮云日初长
千山叠翠春光好	万水扬波气象新
心地光明千丈雾	家庭和睦四时春
风发霸柳绿浪暖	春临柔雪花溪长
当留春光驻华夏	新开世纪属炎黄
国运兴隆如旭日	事业发达胜阳春
雪洁巧铺千里玉	柳柔喜绽万条金
腊梅一院无凋谢	风竹十里有清香
春风陌上翻新绿	时雨枝头含珠红
青山绿水风云静	碧海蓝天日月明
四化宏图酬壮志	两番大业比雄心
喜鹊登枝红梅俏	春风吹柳紫燕欢
莺识新机随日至	燕寻旧主带春来
探得早梅迎献岁	推寻旧历挹韶华
云间瑞气三千丈	堂上春风廿四时
春风堂上初来燕	细雨庭前乍开花
春风细柳飘祥语	时雨长安度半年
一曲笙歌春似海	千门灯为夜如潮
太平有象人同乐	天地无私物自春
春来奇花红映月	冬去芳草碧连天
芙蓉夜日开天镜	杨柳春风拥画图
天泰地泰三阳泰	家和人和万事和
爆竹一声除旧岁	桃符万户换新春
绘我河山添彩笔	献身祖国出良谋
绿柳舒眉除旧岁	红桃开口笑半年
映阶碧草生新色	隔叶黄鹂送好音
春来百花香满地	日照万物喜临门
细雨无声滋大地	春风有意暖人心
火树光腾城不夜	银花焰吐景长春
人尽其才人延寿	物畅其流物生辉
绿荣大地春风动	红染长天旭日高
柳披烟霞山色翠	梅含胭脂春意浓
春染千畴一片绿	雨润万花遍地红
天上四季春为首	人间五福寿宜先
春和草木当庭秀	时泰山河映日红
百年天地回元气	一统山河际太平
千好万好满院好	五福百福全家福
雪消门外千山绿	春到人间万户欢
窗含青山鸟衔翠	门垂碧柳花吐艳
感旧已无清江鹤	怀乡忽见巴山鹃
春到自然山有色	时来依旧水映花
一冬寒风随夜尽	九州春色破晓明
抬头见喜喜满院	开门大吉吉盈庭
一城花雨山河壮	满苑春风天地辉
春风摇醒千门柳	暖雨催开万径花
勤劳修通富裕路	节俭叩开幸福门
八方财神添贵富	四时福星保平安
五风十雨农家乐	万紫千红大地春
丰收酒溢全家笑	致富花开四季春
新年初一大门开	吉星送进福财来
三春淑气盈门室	万里祥光烛斗文
创业莫忘先辈德	成家惟愿后世昌
四海皆春春不老	九州同乐乐无穷
花锦堆云香燕垒	柳丝回韵织莺帘
好事好景好运气	多财多福多吉祥
一勤天下无难事	百忍堂中有太和
桃柳争催春烂漫	云霞长拥日光华
致富欢歌催腊尽	发家喜酒送春来
春风得意花千里	煦日扬辉暖万家
春种满田皆碧玉	秋收遍野尽黄金
春风阵阵宜人意	政策昭昭顺民心
把酒高吟春色赋	扬鞭又唱丰收谣
丰衣足食千家乐	丽日和风百花娇
金镰钩起新弯月	银锄震落满天星
福星高照农家屋	春日永悬致富门
政策英明兴百业	经营合理富万家
生财路上残冰化	致富源头活水来
庆丰年全家欢乐	贺佳节满屋生辉
乍雨乍晴花易老	耐霜耐雪松长青
春到堂前增瑞气	日临庭上起祥光
万木欣春随水绿	百花争艳向阳红
春随芳草千年艳	人与梅花一样清
江南塞北家家乐	天涯海角处处春
无边沃野翻金浪	一片碧波跃玉鳞
松青柏翠山山美	柳绿桃红户户春
剑击歪风春色丽	琴鸣新曲乐声高
河水流长歌千首	春风送暖花万枝
翠鸟争鸣春意闹	红梅怒放喜讯传
牛马猪羊六畜旺	荷花菱藕一池鲜
牛羊并壮猪盈圈	鸡鸭成群鱼满塘
园丁辛勤一堂秀	桃李成荫四海春
遥闻爆竹知更岁	偶见梅花觉已春
雪凝大地梅犹俏	日照高峰松更青
莺歌燕舞春光好	水远山高幸福长
万首新诗吟大治	千杯美酒祝丰年
岁寒显出苍松劲	春暖方知绿柳新
牡丹朵朵开洪福	阳雀声声唱早春
年来年去年年好	岁换岁更岁岁新
百鸟和鸣歌序曲	万民欢愉庆丰年
四海笙歌讴盛世	九州爆竹庆尧天
福如东海千年乐	寿比南山万户春
九州联奏迎春曲	万众同描祝福图
爆竹随心飞笑语	春风着意谱新歌
红日无私照大地	春风得意暖神州
春秋有梦托宏愿	山水飞歌树雄心
春江千里飞虹彩	沃野万顷捧黄金
新岁新春幸福日	好时好景吉祥年
千古传奇惊日月	九州揽胜壮春秋
万众欢腾歌盛世	百花竞放贺新年
声声爆竹传千里	点点梅花又一春
勤劳创下千秋业	科学招来万贯财
庆新春九州如画	度佳节四海归心
九州插上腾飞翼	四海流行开放歌
金鸡一唱千门晓	绿柳千条四海春
喜盈门第至新景	春满人间入画图
新岁高登新境界	好春大写好文章
福寿称心家顺泰	春风得意业昌隆
风递清香梅已绽	春临大地景全新
英雄儿女创新业	锦绣河山入壮图
洒下汗珠春风桃李	迎来硕果秋雨梧桐
户对青山花蕾缀树	门含绿水鱼藕满塘
百业兴昌欣逢盛世	万民愉悦喜接新年
阳春美景山河壮丽	大块文章岁月增新
辞旧岁合力山成玉	庆新春同心土变金
鸟语花香有声有色	国强民富可喜可歌
瑞雪纷飞村村兆瑞	春风浩荡处处迎春
人杰地灵百业兴旺	山欢水笑五谷丰登
华夏中天艳阳高照	神州大地紫气东来
雪满千岩山高月下	春来万里水流花开
福星高照长空溢彩	万事亨通大地流金
两岸三通九州一统	八方四化万紫千红
盛世和平百花齐放	宏图大展万里腾飞
载酒迎春春光丽丽	出门见喜喜气洋洋
事业繁荣门盈喜气	江山秀丽户绕春风
四化蓝图崭新日月	十年规划扭转乾坤
春满人间欢歌阵阵	福临门第喜气洋洋
春雨秋露泽被千里	光风霁月晖洒万家
绿水常言三春如意	青山不语四季呈祥
继往开来千秋大业	承前启后四化宏图
大海方平千帆竞发	征途正远万马奔腾
九派奔流千舟竞发	一元复始万物争春
春夏秋冬年轮又转	东西南北方位永恒
门外青山龙翔凤舞	窗前绿水鱼跃鸢飞
四海归心小康在望	九州特色宏业常兴
四柱擎天金瓯永固	五星耀地玉宇清平
春满九州一元复始	国臻四化百业俱兴
岁月峥嵘青春焕彩	前程灿烂赤县增辉
幸福安详人之企盼	文明富裕众所追求
祖国江山花明柳暗	人民事业月异日新
幸福家庭丰衣足食	文明社会正气清风
党引春风山明水秀	国兴特色物阜年丰
民安国泰千门报喜	地瑞天祥万户迎春
淑气初回天蓝地秀	春光四溢心旷神怡
天送祥和芳春永驻	地呈锦绣盛世长存
四海五湖同铺春景	千家万户均谢党恩
天地九州又增一岁	人民十亿更上层搂
瓶插四友梅兰竹菊	岁转一轮春夏秋冬
月仄日平自然格律	云笺雨墨浩翰文章
丽日煦和春光永驻	惠风恬畅富水长流
旭日出东方光弥宇宙	百花开大地春满人间
舜日尧天万民增福泽	和风甘雨四海沐春晖
大地播春光山青水绿	神州增秀色万紫千红
自力更生创千秋大业	励精图治开万代宏基
翠浪映碧空莺歌燕舞	白云绕青壑柳绿花红
翠柳摇风喧千树翠鸟	红梅映日吐万枝红霞
一夜东风吹红花万朵	三春细雨染绿柳千条
大路通天更喜中华伟	宏图遍地当惊世界殊
五更分二年年年祝福	一夜连双岁岁岁呈祥
东风引紫气江山壮丽	大地发春华桃李芬芳
花团锦簇江山添异彩	虎啸龙吟华夏振神威
把酒庆新春春风浩荡	题诗歌盛世世纪辉煌
紫燕腾欢迎来新日月	红梅绽放换了旧山河
一代英豪揽九天日月	九州华夏展四化宏图
柳绿桃红映一江碧水	莺歌燕舞闹十里春风
政策英明明时寄感慨	国家昌盛盛世乐开怀
日丽风和三春飘翠柳	山青水秀万里展宏图
党振雄风神州千古秀	国兴特色华夏万年春
春风拂大地山河锦绣	华夏转新机岁月峥嵘
争春在草木木荣花艳	取信于人民民富国强
岁岁平安时时交好运	年年有吉处处遇良机
为希望工程添砖加瓦	看风流人物富国兴邦
傲雪红梅笑送九冬景	穿云紫燕喜迎四化春
乐奏埚嵇歌中化特色	舞参犀象贺锦绣前程
趋万里东风层楼更上	沐三春化雨四海同欢
翠竹掩红楼别开天地	青山依绿水点缀乾坤
松柏长青河山千里秀	云霞放彩社稷万年春
年年有庆新年新局面	步步登高一步一层天
一夜度双年年年有吉	五更交两岁岁岁高升
岁岁辞旧岁往岁逊今岁	春春迎新春来春胜去春
含笑腊梅唤醒奇葩千树	溢香春笋挺起翠竹万竿
杏雨飞红喜织千家春色	和风着绿巧绣万里新图
日丽风和绣出山河似锦	年丰物阜迎来大地皆春
辞旧岁劲松染霜松尤绿	迎新春寒梅映雪梅更红
松香竹香梅香香风阵阵	天美地美人美美意重重
江山不老处处山青水秀	神州永春年年林茂粮丰
中华儿女敢揽九天明月	两个文明勤绘四化宏图
鞭炮声欢笑声声声悦耳	国家事人民事事事赏心
伟大祖国迎来满园春色	英雄人民创造举世文明
迎新年万众共饮奋飞酒	干四化九州齐唱改革歌
巨龙腾飞光耀神州大地	睡狮猛醒声震寰宇长空
入户问家声礼乐诗书孝悌	卷帘看春色椿萱棠棣芝兰
万木逢春三山五岭皆吐翠	百花得意万紫千红尽争荣
春至阳回玉宇无尘千顷绿	岁当运转银花有焰万家新
一夜连双岁岁岁六畜兴旺	五更分两年年年五谷丰登
长青树有根独茂勤劳门第	幸福花无种只生和睦人家
爆竹喧腾一代河山光夏甸	桃符披彩几家门第乐春台
红日高照全国共创小康户	经济腾飞普天同庆大有年
山舞银蛇昨日乍消千嶂雪	云飞紫燕今朝先放一枝花
旧风俗旧习惯随旧岁送去	新思想新气象伴新春到来
万众同心创造人民百代福	九州一统迎来祖国万年春
崇俭戒奢美德持家家必富	纳新吐故贤才治国国昌隆
新天新地新人新事新气象	春风春雨春花春月春满园
布谷鸟鸟布谷布下丰收消息	迎春花花迎春迎来大好春光
四化待英才斩棘披荆承大业	九州期志士呕心沥血报春晖
对面一春山又方又正堪仰止	出门两道路何去何从应清分
大地换新颜粮遍田陌歌遍野	山坡披彩装果满枝头笑满林
岁岁喜迎春春为岁首春常在	人人欣向党党得人心党永年
南北共中兴山海开源荣禹甸	城乡皆大定工农联谊乐尧天
瑞色布人间锦绣河山添锦绣	春阳普大地光辉节日更光辉
挥笔写豪情敢向五洲夸特色	放怀抒壮志能教九域起宏图
彩笔绘神州指点江山添秀色	新春思台友愿将日月共光辉
翘首望京华多谢春风常送暖	深情连海宇应凭红豆寄相思
黛墨研碧水疾书竹赋漾春意	素笺染丹霞喜绘梅图颂党恩
赤子盼黄山苍松翠竹暗香里	金瓯思潭月紫雨碧云彩霓中
紫气东来看九州物华酒美人寿	祥云普照喜八桂胜境鱼肥米香
晴雪映梅花预兆丰年太平有象	朝阳连爆竹曰为改岁乐事无边
天时地利人和百业兴隆臻盛世	林茂粮丰物阜万家欢乐贺新春
元日日丽照大地大地风光无限	三春春浓盈山川山川美景绝佳
人民有应更喜龙凤呈祥龟蛇献寿	天地无私试看云霞出海梅柳迎春
瑞雪片片兆丰年家家迎春祝福	祥梅枝枝吐新蕾户户恭喜发财
年胜一年年胜年年年有剩年年盛	月新余月月新月月月纳薪月月欣
梅花红柳丝绿如画江山千里秀	云霞丽松柏青似锦前程万载春
年年喜鹊闹红梅红梅昂首迎红日	岁岁笑颜入春贴春贴满门洽春风
数不尽春光门前绿树阶前玉树	看将来气象千里青云万里轻云
雄儿女风华正茂不愧当代俊杰	绣江山春意盎然堪称人间乐园
山如画水如画心田才是最美画	春是诗秋是诗国策方如绝妙诗
勤劳门第春常在春回大地春光好	节俭人家福先临福满乾坤福气多
门前车兮马兮车水马龙奔富路	世上花也锦也花团锦簇绣文明
青云直上勉中华儿女揽九天明月	紫气东来建两个文明绘四化宏图
四季长留四季青喜看冬季如春季	一年更比一年好定叫今年胜去年
火树银花福寿酒于元春春满玉宇	山鬟水佩拂垂杨之稚绿绿萦金城
凤舞龙飞喜看大好河山生机无限	云蒸霞蔚遥望同胞骨肉团聚有期
四序更新巍巍乎万里长城三春不老	一元复始灿灿兮千年古国九鼎生光
松劲南山鹤栖北野天南海北人高寿	莺歌西月燕舞东风河西江东景长春
党扶正气民扬志气华夏年年增喜气	国倡嘉风家树新风神州处处荡春风
廿四番花信神州大地万紫千红春意满	九十般韶光伟业宏图三山五岭喜事多
穷山变富	旧貌换新
勤劳是本	性善为纲
凯歌动地	战鼓催春
春播千村笑	福驻万户欢
吉祥有喜	富贵长春
生财有道	幸福无疆
五谷丰登	六畜兴旺
山村时雨润	水乡月正明
山欢水笑	喜临人间
全家福气	满院春光
春盈四海	花熳九州
春联映春日	福地托福天
丰收岁月	康乐人家
莺歌燕舞	春到大地
春风得意	丽日舒怀
农家多喜气	六户满春光
春风得意	政策归心
丰收酒浓	勤劳汗香
开门闻喜讯	举步见春光
百花开田野	五福入农家
香飘四季	绿满九州
林木山山绿	鱼鸭塘塘丰
竹影有新意	松风含古姿
红日辉林海	春光焕鸟音
庭荣松柏	阶茂芝兰
田园常有乐	鱼鸟亦相亲
祖国春光好	农村气象新
丹桂香千里	松柏绿万年
山川毓秀	松柏常青
发家勤为本	致富俭当头
江山千古秀	花木四时春
茶园香屋后	柳浪泛门前
高山埋宝	林海藏金
土能生百福	地可纳千祥
林深惊鸟兽	果熟醉山人
高枕随流水	轻帆任远风
万户皆喜色	千村尽春光
竹松添翠色	桃李绽新蕾
匠心随所种	著手便成春
柳笛穿林过	山歌带月行
日丽山河秀	风和草木荣
荒岭成林海	沙滩变绿洲
春拂柳丝翠	秋染枫叶红
日月开新纪	田园人画图
唱晚耽清兴	临波寄渺怀
渔歌随浪涌	海货与山齐
一帆云作伴	千里月相随
田园风光绝好	农家岁月更新
摇橹时弄月	挂帆自生风
春潮新涨碧	银网广织歌
通商为物畅	集贸利农家
欲夺粮丰须细作	力争苗壮务精耕
明月双溪水	轻波一钓船
农家小院溢瑞气	幸福门第增祥光
乘风破浪歌一海	喜笑颜开银满仓
发家勤为本	致富俭当头
草木盼春暖	人民思富裕
一畦春韭绿	十里稻花香
花开群芳谱	人喜丰收年
春到农家院	福临致富门
江山千古秀	中华万年青
政喜千门暖	风和万户春
普及科学知识	提高耕作技术
嫩柳千姿秀	娇梅万态新
江山添秀色	桃李发春华
水清鱼可数	林静鸟无言
红梅伸枝傲雪	桃李含笑迎春
瑞雪漫天舞	红梅报春来
桃李成蹊径	江山如画图
春光何荡荡	雨意且潇潇
搞好科学种田	促进农业生产
佳节家家乐	新春处处欢
春润竹梅门第	喜融楼阁农家
户户安居乐业	村村增产丰收
风掀稻浪金波滚	秋熟棉田白雪铺
铁臂挥舞山河变	银锄起落天地新
乘风出海勤生产	满载而归唱渔歌
一网收来鱼满载	千锄种下谷盈仓
举怀喜庆丰收年	迎宾先唱农家乐
家家粮食满仓囤	人人喜气上眉梢
五谷丰登农家乐	四季增收岁月甜
闹春耕人勤春早	抢农时民乐年丰
梅花含苞迎春到	瑞雪漫野兆丰年
新谷登场万户乐	雄心揽月九天低
马壮人强康乐日	仓流囤满裕丰年
地旺人勤山献宝	春浓日暖国增辉
敲锣打鼓庆佳节	张灯结彩贺丰收
东风化雨山山翠	政策归心处处春
五业并举家家乐	六畜兴旺户户欢
熙春渔港千帆集	出海云涛万网张
勤俭人家先致富	向阳花木早逢春
春风得意花千里	秋月扬辉桂一技
勤劳门第山献宝	俭朴人家土变金
汗洒田园五谷秀	锄描大地万家春
爱竹不锄当路笋	惜花常护入帘枝
缫成白雪桑重绿	割尽黄云稻正青
茧花结出丰收果	汗水汇成幸福泉
花影不离身左右	鸟声只在耳东西
人欢马叫丰收岁	狮舞龙腾改革春
春动生机龙起蛰	物宣时令鸟催耕
晴窗透日桑榆影	晚露湿秋黍禾香
一年生计勤务商	无限春光任剪裁
地开美景春光好	人庆丰收喜气多
林高草茂牛羊壮	水秀山青稻麦丰
国泰民安知礼乐	年丰物阜庆康宁
万壑松涛山雨过	千山花色水风生
东风送暖千山绿	旭日生辉万壑春
竹林葱郁千嶂翠	树海苍茫万顷涛
高岭苍茫低岭翠	幼林明媚母林幽
松色巧开千岭绿	梅香普送万家春
十年树木千秋业	一望江山万里春
风吹杨柳千山绿	雨润杏桃万里红
百鸟齐鸣迎旭日	千林披翠舞东风
绿满林区山滴翠	春回茶场路飘香
植树为求千代福	护林因葆万山春
千只轻艇迎风去	万担鲜鱼上网来
造林直上千重岭	筑坝横拦万顷波
绿屏碧嶂遮风砾	林海雪原育栋梁
千峰苍翠吐春意	万亩碧波浴早晖
秃岭荒山成昔日	青峰绿海看今朝
劲竹在前方见节	腊梅去后尚留香
碧海金波朝旭日	春风银网耀朱鳞
鸟欲娱人娇舌啭	花如爱客笑颜开
祖国有山皆绿化	林区无处不清风
春风习习渔家乐	秋水粼粼夹岸欢
青山不老山犹秀	碧水长流水愈娇
一片晓烟杨柳绿	满园春色杏桃红
百花园里珍禽舞	万木林中好鸟鸣
千林鸟唱山增韵	四野花开果溢香
草绿花红锦绣地	粮丰林茂喜欢村
自闭桃源称太古	欲栽佳木柱长天
万木欣春随水绿	百花争艳向阳红
柳绿梨黄千载福	桃红松翠万年春
熙春鱼港千帆集	出海云涛万网张
海上渔歌随浪涌	岸边欢笑逐风飞
碧波浩渺千帆舞	紫气光华万象新
出海千船迎日出	归程万篓顺风归
万顷烟波天接海	千舱欢笑喜迎春
双桨荡开波面镜	一篙撑破水中天
五岭山歌传吉讯	三江渔唱起春潮
金山银海迎朝日	牧笛渔舟唱晚风
雨顺风调人出海	帆轻云淡船归家
汪洋大海鱼群广	浪静风平水产车
乘风破浪扬帆去	金甲银鳞满艇归
白帆春暖兴渔业	碧海波平唱福音
鱼香醉倒千重浪	螺号唤醒万户春
寒江打网随流水	曲渚回舟带夕阳
渔唱晓迎红日出	风帆暮载锦鳞归
堤外波光千里碧	船中春色万斤银
潮汛朝争歌满海	归帆夕映喜盈舱
港外群帆迎旭日	船中笑脸伴春风
白云春暖千家乐	珠海波平万舶来
集市繁荣财路广	通商无欺物公平
无穷生意赖乡土	有志农民是栋材
科学知识穷山变富	改革精神旧貌换新
春风晓月随流水	小曲轻舟载锦鳞
搞好供销生意好	提高生产赞声多
劳动发家棉铺银床	科学创业稻围金帐
万国嘉宾舟载宝	三山奇景海连云
油盐布匹天天有	农具肥料日日全
植树造林有山皆绿	移花接木到处是春
集市繁荣物价稳	人心安定世风新
南北货任君挑选	工农渠凭我沟通
海笑人欢九州永泰	盐丰鱼跃四海长春
聚四面八方产品	供千家万户需求
政策英明兴百业	经营合理富千家
耕雨锄云迎来幸福	栽花种树装点春光
繁荣市场财源旺	礼貌经商客自多
天复三阳人勤春	牛耕千顷心齐年
花果飘香桑麻挺秀	牛羊肥壮稻菽丰盈
财源滚进勤劳户	幸福频临节俭家
一家和顺应归福	百业振兴皆因勤
五谷今年歌大有	九州到处庆升平
梨花院落溶溶月	春水池塘淡淡风
让富字安家落户	把穷字扫地出门
田园逢春春似锦	劳动致富富盈门
又是一年丰收乐	依然万里建设歌
谷有田园桑有圃	鱼满池塘果满林
日丽风和增福寿	人欢马叫闹春耕
爆竹欢歌丰收曲	春风敲开富裕门
车水马龙农家乐	花好月圆大地春
华夏安定百事好	农家芳春万象新
好山好水好日月	新岁新春新家庭
家家畅饮庆丰酒	处处同吟祝福诗
国强民富太平日	雨顺风调大有年
家添财富人添寿	春满田园福满门
天增岁月地增产	春满乾坤福满门
牡丹朵朵开洪福	阳雀声声唱早春
举五业劳动致富	养六畜经济繁荣
节俭人家穷变富	勤劳门第乐而康
春到山乡千门喜	喜临小院四季春
福星高照农家屋	春日永悬致富门
精耕细作丰收岁	勤俭持家有余年
勤而不足再加俭	耕有余闲且读书
莺歌燕舞春光好	水远山高幸福长
粮棉遍野千村富	桃李满园万家春
山沟长起摇钱树	茧手端来聚宝盆
神州十亿争飞跃	乡镇五业庆丰收
礼义生财庆有道	勤劳致富乐无涯
银锄铁臂五谷旺	骏马新人百业兴
五谷欲结丰硕果	四化先开胜利花
风和日丽送玉兔	水秀山青接神龙
五谷丰登家家喜	三春锦绣处处新
公粮早送心常乐	嘉谷丰收国自安
丰收美景千山锦	致富红花万里香
山青水秀宜耕田	春夏秋冬景色鲜
人强马壮康乐日	囤满仓流富裕年
福星高照家富有	大地回春人安康
爆竹刚唱丰收曲	春风又开富裕门
致富花开青山意	欢声震耳赤子心
五福百福全家福	千春万春遍地春
槽边不乏千里马	仓内常存万石粮
门庭春暖生花草	田亩年丰乐太平
春风暖发金钱树	甘雨浇开富贵花
百福尽随新节至	千祥俱向早春来
掌握科技创大业	黄土育出金和玉
五谷丰登农家乐	四季增收岁月甜
东风习习千丛绿	旭日彤彤万户春
美酒千杯祝盛世	花灯万盏贺新春
致富路上迎新岁	责任田头接早春
光景富裕千载好	山河秀丽四时春
歌声新奏迎春曲	科学精耕责任田
父勤耕耘儿勤书	子孙代代不受愚
春夏秋冬春为首	梅桃李杏梅占先
户户拜年谈举措	家家贺喜话宏图
猪马牛羊六畜旺	荷花菱藕一池香
举足迎春春早到	抬头见喜喜盈门
新年共享丰收乐	盛节同开创业篇
居家同心无难事	邻里和睦共春晖
南岭雪梅开五福	神州喜鹊报三春
金网荡碎满江月	银舱鼓起一帆风
桃柳争催春烂漫	云霞长拥日光华
点点轻舟腾巨浪	阵阵渔歌卷春风
喜捉肥鱼撒大网	欢弄浪花唱新歌
千峰苍翠吐春意	万顷碧波浴朝晖
江山除腐春永驻	神州改革绿已深
绿满林区山滴翠	春回茶场路飘香
春去春来春常在	庆欢庆乐庆有余
往年美景留不住	今春风光驻家园
酉鸡伴随银冬去	戌狗迎着金春来
靠科技六畜兴旺	凭勤劳五谷飘香
山青水绿景色好	草茂花香牛羊肥
杨柳舒眉观新岁	田园醒眼换绿装
园中果木春无数	塞上山林画不尽
迎新春家宁国泰	逢盛世人寿年丰
群山碧千峰竞秀	众河清百舸争流
雪映红梅开笑脸	风翻绿竹谱新诗
熙春渔港千帆集	出海云涛万网张
富进千家家家喜	福驻万户户户春
一海浪涛一海笑	满船歌声满船鱼
五讲四美人人美	万紫千红处处红
好山入座清如洗	佳树当窗翠欲滴
文明门第新风盛	礼貌人家春意浓
分耕包种年丰物阜	精兵简政民富国强
工富农富城乡富	山新水新天地新
万户千家争致富	大河小泊竞洗贫
多种经营四路进宝	全面发展八方生财
春染千畴时时绿	雨苏万物处处歌
万户箫歌赞盛世	千家诗画颂丰年
入耳歌声不分童叟	满眼绮丽难辨城乡
文明待客心常乐	礼貌经商品自高
布谷鸟声声催播谷	迎春花朵朵喜迎春
搞活流通加深改革	繁荣经济稳定市场
绿染千畴挥锄夺宝	春临大地洒汗成金
乘东风划破千层浪	操船舵满载万担鱼
操舵扬帆渔歌飘海	乘风破浪锦鳞满舱
千里松涛无山不绿	万顷麦浪有地皆黄
植树造林包装大地	栽花种柳点缀山河
水秀山青阳春有脚	年丰人寿幸福无边
植柏植松无山不绿	栽杨栽柳有岭皆春
克勤克俭万事荣兴	勤俭持家人人富裕
户户家家同致富	行行业业共繁荣
六和三阳福如东海	五讲四美德若泰山
有农有副百业发展	门迎绿水荷藕满塘
春风又绿千顷地	肥水重入万亩田
山青水秀阳春有脚	人寿年丰幸福无边
集体道同结幸福果	责任制竞开富裕花
足食丰衣家财旺	荣华昌盛国运兴
千里遥途始于足下	四化大业创自手中
商海遨游勇者胜	市场竞争智为先
春风吹开万朵春蕾	新年展现千幅新图
沃野千里生财有道	良田万顷劳动致富
国泰民安四化有望	风调雨顺五谷丰登
靠市场生财多路	凭智慧致富有方
勤俭持家家家福裕	改革创业业业兴旺
民安国泰千门接喜	地瑞天祥万户迎春
四海同心惠风和扬	万民交庆化日舒长
文明村里花香鸟语	责任田头日丽风和
牛奋四蹄虎添双翼	人增干劲国奔小康
花香鸟语人勤春早	风和景明民乐年丰
春到山欢水笑人乐	时来国昌家和民富
万紫千红百花齐放	三江四海五谷丰登
春暖花开同迎丽日	人强马壮共夺丰收
红旗舞东风五湖泛彩	丰年兆瑞雪四海同春
农林牧副渔业业兴旺	油盐柴米布样样有余
五谷丰登喜迎大有日	六畜兴旺好过太平年
艳阳照大厦春华竞发	甘露洒人间瑞气勃生
山乡柳绿桃红春意闹	农家稻花香里唱丰年
富源常开勤俭通富路	春光永驻改革报春华
双手茧花结出丰收果	一身汗水浇开幸福花
鹊闹红梅村村传捷报	童嬉绿野处处闻笙歌
笑语欢歌喜庆农家乐	名诗佳画大赞神州春
家有聚宝盆招财进宝	院栽摇钱树致富生钱
发家无巧勤劳为根本	致富有道科技做靠山
张灯结彩欢庆丰收岁	笑语欢歌喜迎艳阳春
十亿神州共驰千里马	四化建设更上一层楼
和风吹绿野人勤春早	祥云吐细雨物阜年丰
雪铺富裕路银光闪闪	鹊叩幸福门喜报声声
元宵灯下畅饮丰收酒	除夕宴上欢唱迎春歌
美美美日子愈过愈美	甜甜甜生活越来越甜
先富后富靠劳动致富	兴家养家须勤俭持家
年复年年年气象更新	岁连岁岁岁捷报频传
九天春雷开中华泰运	四海欢歌庆改革奇功
五讲四美新风拂大地	万紫千红春光耀人寰
村旁小溪流来幸福水	门前大道通向金银山
金鼓点点载起迎春舞	银弦悠悠伴奏百花歌
红旗舞东风五湖似画	瑞雪兆丰年四海皆春
田野欣临春风春雨春景	万家喜有新谷新财新家
渔歌互答齐唱丰收乐	同船相邀同绘闹春图
五谷飘香香透千山万壑	双燕报喜喜盈四舍三邻
人康物阜侨乡放春色	国泰年丰四化展宏图
生产致富送走一穷二白	勤俭节约迎来万紫千红
世开新局九州歌大治	党拓鹏程万众步小康
发展多种经营财源茂盛	大搞科学种田五谷丰登
牧笛悠悠草原牛羊走	鞭花朵朵塞上骏马驰
紫燕高飞剪开千里云雾	布谷欢歌唤起万家春耕
开门见喜个个心花怒放	过岁迎新人人笑逐颜开
年年进宝年年添福年年乐	岁岁招财岁岁有余岁岁欢
犁刀如剪裁就满园春色	锄头似笔写出致富新篇
喜村寨五谷丰登粮山棉海	看城乡一派兴旺车水马龙
有三卷引路信前程远大	看红梅开脸歌生意兴隆
泰运宏开五谷丰登歌大有	春光明媚百花齐放庆升平
科技村文明村村村兴旺	专业户重点户户户丰收
暖雨迷蒙携镢宽山齐植树	春风飘拂扶犁耕野竞分秧
春风春雨送来九州春色	新天新地造就一代新人
锣鼓喧天处处春风报喜讯	彩旗映日家家喜酒贺丰年
八音响彻八方八方致富	七色光临七曜七曜增辉
法治安民田增五谷人增寿	政策顺意春满九州福满门
炎黄子孙佳风勤劳俭朴	中华民族本色果敢坚强
东风浩荡穷乡僻壤皆生色	秋雨淋漓废井颓垣亦刷新
杏雨飞红喜织千家春色	春风似剪裁成锦锈江山
比贡献夺丰收共驰千里马	赛雄心创高产更上一层楼
一夜连双岁岁岁六畜兴旺	五更分两年年年五谷丰登
靠政策致富家家金流玉淌	凭科学发家户户囤满仓溢
田有嘉禾时望春风时望雨	宅无别物半藏农器半藏书
俯首低吟百年诗赋萦头脑	高瞻远瞩万里风云入壮怀
辞旧岁喜丰收共饮庆功酒	迎新春看美景合力夺丰年
六出飞花喜见工农传捷报	九州春晓争攀科技最高峰
一曲农家乐乐满家家户户	千盏透杯香香遍寨寨村村
体制革新社会繁荣臻大治	边防巩固人民安乐庆升平
金鸡报晓共唱天下春色美	黄龙新跃喜看中华气势雄
致富有方人民生活步步高	安邦得法祖国面貌日日新
湖水碧绿群群鲜鱼待撒网	春光明媚匹匹骏马好腾蹄
北斗回寅万户金鸡争唱晓	东风送暖九霄玉兔喜迎春
翠柳九行喜迎白鹤栖渔户	碧波千顷笑送红鲤跃龙门
改革时代万民康乐齐称好	开放岁月经济腾飞再登高
冰消雪化好河山五光十色	冬去春来新岁月百态千姿
勤俭建国心血谱写丰收曲	艰苦创业汗水浇开幸福花
竹翠梅香共喜春光融画卷	旗红日灿同挥热汗写诗篇
山美水美春光美宏图更美	人新事新年代新伟业长新
日新月异千树红花映丽日	水唱山欢万张笑脸迎芳春
会管理善经营致富全靠政策	沐朝阳沾雨露丰收不忘国家
大地回春山山水水风光美	政策归心行行业业气象新
你进步，我进步，人人进步	户文明，村文明，处处文明
梅花朵朵，含苞吐蕊迎春到	瑞雪片片，漫野弥山兆丰年
盛世十亿歌十亿同歌歌盛世	新春九州乐九州共乐乐新春
绿野展门前喜看丰收歌盛世	春水接天长一网收来鱼满舱
中华巨龙腾飞光耀神州大地	东方睡狮猛醒声震寰宇长空
大地换新颜粮遍田陌歌遍野	山坡披彩装果满枝头笑满林
农为根本喜看农民发家致富	学为专长欣闻学子磨砺成材
龙飞凤舞万里蓝天春晖无限	人欢马叫九州大地气象万千
窗含春耕画图铁臂银锄翩翩舞	门迎丰收喜讯金珠王粒滚滚来
东南西北中齐促四化快发展	农林牧副渔共庆五业大丰收
勤劳致富吃好穿好住好生活好	政策归心天新地新家新气象新
山水田林路综合治理生财路广	农林牧副渔多种经营致富门宽
喜十亿神州人才辈出群星灿烂	乐四化宏图中兴在望捷报频传
柳绿桃红看大好河山皆成锦绣	春华秋实望无边田野尽是黄金
辞旧岁，人民十亿重添十倍劲	迎新年，四化建设更上一层楼
月圆花好看大地又沐春风瑞气	燕舞莺歌祝神州重开舜日尧天
瑞雪片片兆丰年家家迎春祝福	祥梅枝枝吐新蕾户户恭喜发财
农林牧副渔业业兴旺	油盐柴米布样样有余
异草奇花添几分春色	桩头盆景夺一代天工
岁通盛世共奏迎春曲	人逢华年同抒改革情
映日红梅香飘致富路	摇风疏柳绿染小康家
锄草庄稼旺挥锄夺宝	养猪积肥多变肥成金
装点江山林教千壑绿	造福后代水理万泉清
日丽风和山河添秀色	地灵人杰田野沐春风
促进购销方方皆顺畅	繁荣市场处处亦兴隆
看九州物华酒美人寿	喜八桂胜境鱼肥米香
植树造林青山长不老	种草栽花赤县永留芳
银燕穿云巧裁三春美景	金鸡报晓喜获五谷丰登
生产所需保证企业供应	日常百货满足人民要求
闹春耕十分汗水十分获	抢农时一寸光阴一寸金
利国利民广辟生财之道	兴家兴业多寻富裕之门
松柏拂春风山河弃旧貌	杨柳迎丽日田园着新装
实行因地制宜生财得道	发展多头经济致富有门
山水间到处献来金树	乡村地刹时腾起钢龙
充分利用水源水肥水美	科学管理鱼塘鱼大鱼多
一曲农家乐人随春意泰	千盏透杯香年共晓光新
鱼跃鸢飞滚滚春潮催四化	月圆花好融融喜气遍九州
铁臂银锄装点河山似锦	和风丽日沐浴大地皆春
松下围棋松籽每随棋子落	柳边垂钓柳丝常伴钓丝悬
精耕细作夺取丰收干劲大	奋发有为振兴中华贡献多
渔汛兴隆乐朝四海抛鱼网	锦鳞生色喜看五湖载半年
海倒山移春野无边翻稻浪	渠成水到乡村遍地荡银波
应群众所需供销日常用品	为民生服务收购农副物资
喜江南柏翠松青风光正好	望塞北梅红竹绿气象更新
顾客盈门买卖活经营有路	供销皆旺生意好聚财有方
四季香飘姹紫嫣红春不老	九州绿化茂林修竹草常青
购土产收山珍为农民着想	促产销卖农具供生产所需
翠柏苍松装成祖国千年秀	朝霞夕照染就江山万代红
礼貌经商衡量度公平交易	文明待客老中青一视同仁
渔手捕鱼五湖水族皆听命	船艇出航四海龙王助顺风
春雨秋风看大好河山都城锦绣	粮山棉海览无边景物尽古芳菲
举目看山山山葱葱山山宝	低头见水水水清清水水银
供其所需销其所售莫忘两肩重任	扶之以始持之以恒繁荣多种经营
柳绿桃红看大好河山皆成锦绣	春华秋实望无边田野尽是黄金
生产向前好机器宜及时养护	检修勤搞旧农具应努力翻新
春水接天长一网收来鱼满载	东风吹地暖千锄种下谷盈仓
供应日常杂货便利农村需要	售销工业物资任凭群众选挑
瑞雪染腊梅白里透红一两点	和风扬杨柳动中有静四五枝
经营品种多宜生产也宜消费	业务范围广管收购还管供销
城乡合办厂取长补短增加效益多贡献	工贸搞联营你产我销减少环节大兴隆
敢改敢革当实现四化先锋模范	肯学肯钻做经济建设里手行家
天上月圆人间月半月月月圆逢月半	今夜年尾明日年头年年年尾接年头
农村兴旺同庆丰收谷似金山棉似海	城市繁荣共迎新岁车如流水马如龙
行大道，立大法，昭大信，臻大治	庆新年，焕新猷，创新局，布新风
旧岁更新爆竹声声喜听去年奏佳音	新年伊始红灯盏盏欣望来岁锦添花
爆竹刚送丰收岁喜往昔步步增锦绣	红梅又迎跃进年看未来日日生光辉
党兴军旺	东风化雨
办事公道	对党忠诚
为人民服务	做群众公仆
民主春风劲	长城战鼓擂
实事求是	以身作则
伟业千古	福泽万年
春浓催四化	日暖励长征
四海风雷激	九州岁月新
法严政通	政策归心
先公后私	舍己为人
按政策办事	从实际出发
不坠青云志	勇攀泰山巅
春意无限	江山多娇
千秋业绩	一代风流
钢枪震敌胆	铁骑踏贼营
有公德乃大	无私品自高
国富民强	政通人和
九州安定	万众团结
英勇保祖国	光荣耀家乡
不矜威益重	无私功自高
胸怀国计	心惦民生
相信群众	依靠人民
真钢自有质	事业无穷年
神州春意满	大地颂声高
兴利去弊	除旧布新
雄心创伟业	妙手写春秋
军属人人敬	功臣个个夸
政善民皆喜	法严国永宁
实事求是	大公无私
伟业千古秀	神州万年青
苦战兵犹乐	功高将不骄
锦帚扫败叶	春雨发新芽
人民伟大	政策英明
劳动葆本色	廉洁亮高风
心齐江河变	志壮泰山移
有胆识骏马	无畏护良才
红日悬赤县	春风暖神州
大好前程似锦	革命重任如山
投鞭断流渡险	击鼓飞旗夺关
座上清茶依旧	国家景象常新
新曙遍玉宇	春光满神州
坚持群众路线	发扬民主作风
坚持四项原则	建设两个文明
实践检验真理	政策鼓舞人心
心怀十亿人民	胸装四化伟业
治国人民为主	安邦法律有章
军属门上光荣匾	战士胸前胜利花
一身正气祛邪气	两袖清风拂歪风
任劳任怨挑重担	全心全意为人民
加强法制顺民意	落实政策得人心
克己奉公昭正直	为民做仆倡清廉
铁面无私党风正	执法有据民心安
民气复苏地换貌	党风端正国增辉
愿与人民同甘苦	誓同山河共存亡
千家团圆英雄愿	万代和平战士心
十亿人民歌盛世	新年愉快仰东风
处处替人民作想	事事与群众商量
人民战士千古秀	革命英雄百世芳
军民团结如一人	试看天下谁能敌
一片丹心献四化	两袖清风为人民
政由德布宜崇德	官与民亲贵爱民
树立正气准则为镜	端正党风从我做起
光荣传统光荣史	英雄阵地英雄兵
千枝挺秀看朋辈	万物同春治干群
东风吹暖英雄门第	喜报映红光荣人家
鱼水情深花愈美	军民团结春更浓
四项原则立国本	三春乐章歌心声
政策英明百行兴旺	春风和暖万象更新
新春邻里传捷报	佳节锣鼓庆功臣
人民军队无敌手	和平事业有靠山
举国上下安定团结	大江南北礼貌文明
烈士精神人人敬仰	革命传统代代相传
发扬民主广开言路	严明法制维护治安
日月知心三阳开泰	新老交替万古长春
劳武结合常备不懈	军民团结鱼水相连
心存民生同百姓乐	胸怀国计先天下忧
春回大地百花齐放	日照神州四化宏开
人民军队所向无敌	钢铁长城坚不可摧
人民生活安居乐业	国家经济锦上添花
锦绣山河天长地久	安定团结国泰民安
保家卫国全民有责	当兵服役满院增光
文明国里春风送暖	长征路上战鼓催征
赤胆忠心报效祖国	披坚执锐保卫边疆
人民力量掀天揭地	群众智慧倒海移山
先烈打江山伟业千古	吾辈搞四化福泽万年
一代英才九州生气	八荒交替万古长春
兢兢业业为人民服务	老老实实向群众学习
兴利除弊江山永固	选贤任能大业中兴
看祖国前程信心百倍	望世界未来豪情满怀
祖国春回欢天喜地	中华崛起吐气扬眉
前辈为革命南征北战	后代奔四化催马扬鞭
按经济规律发展经济	为人民利益造福人民
开天辟地先辈耀华夏	继往开来后贤转乾坤
前程党指引凯歌高奏	政策民拥戴捷报频传
世盛年丰祖国春光好	民康物阜城乡曙色新
做社会公仆披肝沥胆	为人民服务竭智尽忠
发扬谦虚谨慎优良传统	坚持实事求是科学精神
披荆斩棘开创新局面	发愤图强改革旧作风
手握钢枪加强战备观念	胸怀朝阳保卫祖国河山
替群众办事真心实意	为人民掌权廉洁奉公
胸怀革命利益坚持真理	甘为人民公仆不搞特权
纤尘不染真诚当公仆	朴素无华老实做村民
老传统老作风发扬光大	新思想新道德蔚然成风
建设四化赖一代俊杰	指点江山有无数英雄
知人善用四化花繁叶茂	才路广开群星灿烂云集
选拔人才建千秋伟业	改革机构开一代新风
春风吹春雨洒百花齐放	党纪严党风正万事皆通
节届新春更念台湾骨肉	时逢盛世倍思海外同胞
各族同心建设文明社会	全民协力打扮锦绣江山
克勤克俭劳动人民本色	任劳任怨革命干部作风
庆佳节，秦岭思念阿里山	度新春，渭水情恋日月潭
军民一家铁壁长城千里固	党政协力锦绣江山万年春
又红又专高唱凯歌跟党走	能文能武满怀壮志展翅飞
正党风秉公办事光明正大	拉关系托人施情理应知羞
华光照四海四海皆春春不老	佳节临九州九州同乐乐无穷
风卷残云边关英雄威似虎	血洒疆场民族正气浩如虹
念骨肉同胞岁岁雁书传乡语	怀台湾宝岛年年红豆寄相思
清正廉明事事为人民做主	谦虚谨慎时时以公仆自居
游子思故乡岁岁年年情愈切	侨胞爱祖国朝朝暮暮意更深
大业有望东风习习送冬去	气象更新红日彤彤迎春来
眼观六路注视世界风云变幻	耳听八方守卫祖国边疆安宁
大江沃野，共育炎黄子孙	山峡海浪，齐盼祖国统一
中华盛世四海侨胞从天涯归	贸易兴隆五洲朋友自远方来
脉脉情怀思亲人，终当团聚	丝丝心曲盼宝岛，早日统一
不惟上不惟书事事从实际出发	应为民应为党人人按准则要求
异乡梦远，隔山隔水不隔心	故土情深，忆草忆木更忆人
英雄门第	革命人家
提高警惕	保卫祖国
不怕流血汗	但求安家邦
战士千秋美	英雄百世芳
坚如磐石	固若金汤
云雾作帐	大地为床
祖国领海固	人民幸福长
风尘三尺剑	社稷一戎衣
效忠祖国	保卫边疆
人民子弟	祖国长城
三军丧敌胆	四化壮国威
导弹架上弦	神州心中固
铜墙铁壁	富国强民
三春美景	万里长城
号角传捷报	军旗奏凯歌
卫长空永固	保大地长安
人民军队	钢铁长城
军民义重	鱼水情深
美酒敬模范	红花献英雄
功名归祖国	荣誉属人民
身在蓝天	心系大地
长缨在手	壮志萦怀
士气安社稷	军魂镇关山
开创四化业	紧握五尺枪
心向祖国	志在边防
建设祖国	保卫国防
三军雄虎节	万里壮龙韬
丹心扶社稷	铁骨护山河
端枪挑晨雾	举步迎春光
柳营春试马	虎帐夜谈兵
战士热血融冰雪	哨所威势镇边陲
练出金睛火眼	筑成铁壁铜墙
英雄儿女英雄志	钢铁长城钢铁人
铁甲气挥霜露冷	战刀光射斗牛寒
花香幸福门第	喜涌光荣人家
文能安邦定天下	武可治国保乾坤
愿与人民同甘苦	誓同疆土共存亡
英雄肝胆男儿血	祖国疆土母亲心
关心世界大事	紧握手中钢枪
保家卫国不畏虎	巡逻站岗敢擒龙
赤胆忠心干革命	赴汤蹈火为祖国
勒马横刀守边卡	持枪列阵筑长城
兴邦有策苍生福	卫国保家赤子心
人民战士千古美	革命英雄百世芳
哨卡钢枪锃锃亮	战士目光炯炯明
壮志凌云真俊杰	精忠报国是英雄
春日照人多暖意	长城卫国御寒潮
万众一心卫祖国	千军协力固长城
边陲浴血报国志	南疆热土赤子心
戈戟驰驱挥落日	旌旗彪炳舞春风
挥锄握镰搞建设	磨刀擦枪保国防
英雄功绩千秋颂	烈士英名万古传
三大纪律皆遵守	八项注意永不忘
一人苦累喜眉宇	万户安乐甜心头
请缨卫国英雄汉	投笔从戎子弟兵
独有英雄驱虎豹	更无豪杰怕熊罴
甘洒军人一腔血	换来边塞四季春
公民入伍增光辉	战士戍边保太平
军营春色年年好	官兵情谊日日深
勇做祖国一战士	练成文明两用兵
鱼水相亲传佳话	军民联防筑长城
铁拳砸碎旧世界	刺刀拼出真英雄
鱼跃碧海赞海阔	鸟飞蓝天颂天高
守海疆披肝沥胆	驭铁鲸破浪迎风
守边疆枕戈待旦	卫祖国跃马横枪
一枝红梅掩哨所	满腔热血保边疆
祖国山河皆锦绣	人民子弟尽英雄
心贴人民军威壮	胸怀祖国胆气豪
敌失人心愈丧胆	炮鸣正义更有威
边塞英雄传捷报	沙场壮士立大功
前线杀敌是勇士	后方建设做尖兵
虎胆英雄驱强寇	金戈铁马保江山
鱼水相依情万里	军民团结如一人
蹈火赴汤驱外寇	枕戈待旦守边疆
古寨英魂今犹在	边陲卫士永流芳
一颗红心向祖国	百倍警惕守海疆
春意饱含国防绿	朝霞尽染领章红
银帆万里征湖海	丹心一片保宁安
群山回荡团结曲	大江洋溢鱼水情
仁义师严阵以待	子弟兵众志成城
德洒疆场壮心不已	镇守边卡梦寐以求
千艇竞发卫海域	万里长征展壮猷
百族有方致富日	三军无敌国强时
愿与人民同患难	誓拼热血固神州
军民携手铜墙铁壁	工农协力国富民强
战士心头传春早	长城关口报捷多
保国卫家匹夫有责	参军服役全家增光
为国为民的请进来	升官发财的滚出去
出没波涛三万里	笑谈今古几千年
英雄花开英雄门第	光荣灯挂光荣人家
人民江山铜墙铁壁	英雄儿女众志成城
海上轻骑负重任	浪头小艇破大敌
爱民歌曲曲歌亲人	拥军酒杯杯敬英雄
民富国强天下大治	兵精粮足社会小康
英雄功绩昭百世	烈士芳名耿千秋
人民长城坚如钢铁	祖国边防固若金汤
爱兵如子有战必胜	敬民若父无坚不摧
英名万里传虎将	浩气千秋壮国魂
革命烈士永垂不朽	人民英雄有口皆碑
英雄勋业光昭日月	烈士芳名永垂青史
手握五尺保卫十亿	胸怀四化威镇九州
党纪国法金科玉律	群情民意铁壁铜墙
保家卫国新贤女	习文尚武好英儿
又兵又民兵民兼顾	亦劳亦武劳武结合
国法严明百姓皆歌	除害安民万众欢腾
将勇兵精凯歌传大地	山明水秀春色满神州
记宗旨办事一丝不苟	守准则执法铁面无私
展望前程开创四化业	提高警惕紧握手中枪
天高地远，发发命中	赤胆忠心，个个英雄
战士珍惜祖国寸寸土	人民喜爱英雄拳拳心
常备不懈，守岛一条心	齐心协力，建岛一家人
同泽同胞，剪除国耻	如荼如火，严肃军容
能文能武能谱四化新曲	保国保家保卫大好河山
钢枪伴朔风威震万里	红星迎白雪辉映四方
乘东风，稳上航天轨道	创奇迹，猛攻科技尖端
兵不血刃，攻心为上	将自弹琴，夺神方高
溪流欢歌歌唱哨兵卫疆	花卉含笑笑迎战士巡逻
卫国保家为军人天职	同甘共苦得将士欢心
跨骏马保边疆高山列队	握钢枪守国门青松结屏
献身四化鲸鱼跃大海	实现两番雄鹰击长空
面对南风窗口一身正气	驻守经济特区两袖清风
铮铮铁骨，英烈传颂天下	堂堂卫士，战绩永存千秋
互帮互爱，军营温暖如春	为党为民，战士心红似火
美酒年糕，先要拥军优属	挡风御雪，莫忘铁壁铜墙
疏柳依依农家院落添新绿	青松挺挺军属门第多香风
饮露餐风英雄枕戈抒壮志	战天斗地壮士扬眉卫国门
革命前辈，勇驾风云改世界	英雄后代，敢教日月换新天
防贼抓贼，有贼休想漏网	爱岛守岛，是岛都能扎根
创大业，保国防，横马跃刀	振中华，开宏景，荐良举贤
放哨执勤平凡岗位平凡事	迎风冒雪钢铁长城钢铁人
饮水思源，颂歌一曲赞盛世	青梅煮酒，甘露千杯敬英豪
爬山卧雪热血融融化春水	戴月披星丹心昭昭映河山
用汗水作彩墨印染壮丽青春	将钢枪当画笔描绘美好理想
骋九重天，宇宙飞镖穿八极	波四万里，南极红旗耀五星
先烈推倒三山，伟业千古秀	吾辈实现四化，华光万年春
祝捷红花，朵朵献英雄战士	立功喜报，张张送光荣人家
乘风破浪练本领，擒龙能手	披星戴月守海疆，卫国英雄
春回大地，四化建设鲜花艳	喜满军营，两用人才硕果丰
人民英雄，奋斗一生留业绩	革命传统，激励万代展宏图
革命战士忠于革命身献革命	人民军队来自人民心向人民
打天下，革命先烈气吞宇宙	展宏图，英雄战士功盖千秋
练硬功，保边陲，已传捷报	逐豺狼，反侵略，再请长缨
扎根边疆，爱山爱水爱人民	保卫祖国，尽心尽力尽义务
梅为百花魁，首开英雄门第	春是四季头，先访军属人家
身处南疆，向十亿人民奉赤胆	心怀祖国，为四化建设献青春
神州号角长鸣，万民奔四化	太空凯歌高奏，一箭送三星
眼观六路，密切注视世界风云	耳听八方，警惕守卫祖国边防
又红又专，官兵一致部队好	能文能武，军地两用人才多
鱼靠水，水养鱼，鱼水情意重	军爱民，民拥军，军民骨肉亲
守土有责，战士红心昭日月	保疆无私，边陲烈火写春秋
英雄门第出英雄英雄来自群众	光荣人家增光荣光荣属于人民
战必胜攻必克解放军兵精将猛	地尽利物尽用新中华民富国强
赤心骄子有志塞北江南创伟业	热血青年献身天涯海角固边陲
勇攀四化高峰，喜迎新春旭日	搏击万里长空，捍卫祖国蓝天
铁骨惟坚，担万里江山千秋业	柔肠百转，系十亿父老四海情
爱民曲唱遍大江南北，春添美	拥军歌响彻长城内外，国更强
轻骑踏瑞雪严冬自铁马蹄下消去	钢枪挥红花新春从战士肩上归来
入碧海，龙王设宴慰劳南极探险队	上蓝天，玉帝举杯迎接卫星通讯兵
军爱民，民拥军，互帮互学谱新曲	水养鱼，鱼游水，相辅相成记华章
你也苦，我也苦，咱们不苦谁吃苦	你有家，我有家，没有国家哪有家
抱神州，托日月，战士卫国担重任	兴中华，绘彩虹，军民联防筑长城
卫国戍边疆，虽然饮雪餐风心如铁石	杀敌为人民，不怕披坚执锐志似金刚
脚踏礁石，怀抱大海，十级风浪练本领	心向灯塔，头顶红星，一支枪杆保国防
热血男儿，华夏子孙，效命疆场何所惜	守如泰山，坚如磐石，一代风流传后人
铁马金戈，兵精粮足，祖国屏障金汤固	红星绿甲，志壮情豪，神州堡垒磐石坚
坚致为上	鼓铸独良
科学昌盛	纸业兴隆
潜山文子	京兆韩康
形佳状彩	外秀中坚
万家灯火	一片光明
天机活泼	大块文章
尺度神韵	剪裁风流
素以为绚	青出于蓝
百业兴旺	九州腾飞
城乡互助	工农联盟
钢花飞溅	铁水奔流
东风劲疾	铁蟒飞驰
电光试晓	炉火回春
杏林橘井	玉札丹砂
双南品重	千镒名高
长途无阻	缩地有方
迎春报喜	跃马登程
地下长河	天上明灯
宁停三分	不抢一秒
机器飞转	电灯常明
一炉鼓响	百炼钢成
多装快运	利国益民
经纶天下	衣被苍生
丝丝入扣	事事顺心
层楼迭起	万众欢欣
安居乐业	喜气盈门
金针凤舞	玉尺龙飞
良工手段	君子心情
百年大计	质量第一
千金日利	三雅风高
云蒸霞蔚	锦簇花团
名驰四海	声上九霄
中流砥柱	大雅扶轮
都传千里话	可省百倍劳
春风来海上	明月在江头
四通更八达	六合为一家
纵横千里	联络四方
织成云霞锦	绣出草木花
服务比优质	装卸讲文明
片时即可达	百里亦非遥
朝发夕至	此感彼通
传千里音信	慰万家情怀
空中悬线索	道上任飞行
学铁人精神	走大庆道路
日行千里	夜航八百
话借交通电	名称德津风
水光遥接汉	虹气上凌虚
和时间赛跑	为人民立功
春潮溢彩	煤海生龙
聚为千亩雪	纺出万机云
云水无拘束	江天任春留
热情送旅客	安全步康庄
置邮传命	为政在人
送九州书信	传四海佳音
往来送轨辙	出入在通衢
经邦成大业	煮海仰宏猷
乘胜前进	捷足先登
两轮如日月	一袖定乾坤
车辆如梭去	佳音似电来
冷江映波月	锑都歌九天
日送千家信	时通万户情
无浪行千里	有风送万程
巧手千家衣	美化四季春
点缀身上锦	打扮人间春
当攻关闯将	做长征先锋
不借风帆力	全凭水火劲
飞车连万户	银线通九州
心中春浩荡	井下日光华
经营有大志	建造集良工
开时代列车	做建设先锋
钢钎一笔画	铁水万卷诗
刀剪千色布	针缝万种衣
协力山献宝	同心土变金
春风翻雪浪	炉火荡金波
万家资利用	五彩焕光华
旋转疑下雪	推机似出云
金乃五行首	银为百花饰
为子孙创业	替民族争光
枝头开玉蕊	树上吐银花
锻炼在火里	清白留人间
银花呈异彩	宝树献金辉
悬将小日月	照彻大乾坤
献身擎大厦	捐躯驾长虹
银灯光宇宙	朗月照乾坤
嶙峋成大器	磊落有良工
闪影同天笑	流光夺月辉
普天开景运	遍地转新机
双肩挑日月	两手绘河山
彩瓷成器皿	优质利民生
丝纶常执掌	经纬自分明
英雄登金榜	模范戴红花
日日夺高产	年年奏凯歌
机器声声喝	肥源滚滚来
广厦连云立	春风送暖来
春风传捷报	凯歌贺新年
活跃城乡市场	沟通物资交流
喜看飞虹联彼岸	且教天堑变通途
飞行力足追风去	乘坐心疑逐电行
车达千村万寨	情送四面八方
天上文光添异彩	人间科技建奇功
脚踏双轮千里马	心怀祖国四化业
支援工农生产	促进城乡经济
祥云春暖千家乐	大海波平万舶来
梅花点点新春到	汽笛声声旅客来
珍禽巧绘可细赏	佳木细描更耐观
人民铁道通四处	祖国资源利八方
千里路朝发夕至	两地货南流北通
愿将天上云霞绮	换作人间锦绣衣
一纸音书传千里	四方喜讯送万家
千年龙潭蒸琥珀	万古仙桥起祥云
跃进争当千里马	任劳甘作老黄牛
梅寄春风劳驿使	葭怀秋水托鸿邮
煤海滚滚翻波浪	钢山巍巍入云霄
电波万道传春讯	鸿雁双翅报佳音
做技术革新能手	当增产节约标兵
万众一心齐努力	百舸千帆竞上游
英雄儿女闯万险	浩荡东风鼓千帆
循规应时凭双线	风驰电掣越千里
人穿时装精神爽	物着彩漆面貌新
高高兴兴上班去	平平安安回家来
大开山门寻珠宝	广纳科技接财神
飞觞共醉天边月	鼓棹长开水上花
文明行车争先进	礼貌服务送春风
消忧去愁身长健	除害灭病品自高
平地四轮争逐电	都城十里快兜风
物华天宝资源富	人杰地灵效益多
乾坤有方能旋转	牛马无知亦效灵
劈山造湖兴水利	采煤发电撒明珠
巧使神机械妙手	劈开鬼各出乌金
滚滚乌金出煤海	皑皑白雪映矿山
炉火冲天明日月	锤声震地响春雷
宝盒丛中藏翡翠	金钗队里护鸳鸯
绿字赤文皆可诵	淡妆浓抹总相宜
云头湘湘开金屏	水面沉沉卧彩虹
游客撒下千般乐	船舟载来一片春
轻黄嫩绿齐生色	姹紫嫣红总入时
好将妙手夸针巧	漫把春光细剪裁
大好河山收眼底	满天云彩铺路基
银镰生彩春潮涌	炉火闪光丽日新
贮在玉壶由人造	结成晶块夺天工
玉甑蒸开天地眼	金槌敲动帝王心
认出庐山真面目	装出罗汉古须眉
银屏生辉照四海	图像放彩乐万家
万紫千红出泰地	七彩五色落人间
邀来日月悬隆准	搅得河山入玉眸
无须人力璇玑动	巧夺天工玉屑飞
镰刀收割胜利果	铁锤绽出幸福花
翠竹编成千样雅	青条做就百般精
剪绿裁红装春色	挑花绣朵美仪容
支农甘酒千滴汗	为国愿献万吨肥
千炉钢水汇成海	万丈高楼耸云天
创名牌状元及第	讲信誉顾客盈门
金碧丹青资色泽	门阁楹器焕光华
铁水奔流映喜报	钢花灿烂织春光
千门万户同时亮	五岳三山共线牵
喜博子金千倍利	时交丑纽万家春
金梭织就千重锦	巧手绣成万朵花
珊瑚架映鲛绡艳	翡翠橱开凤锦斑
沙里淘来金足赤	炉中炼出火纯青
热火朝天为四化	纤柴着意临万家
事业已归前辈录	典型留给后人看
绘声绘色真姿相	有彩有光巧工程
闪烁金光奇同天笑	玲珑玉照巧夺月辉
翻天覆地山河壮	紫阳红尘日月新
春入船唇流水绿	人归渡口夕阳红
地辟康庄无往不利	车同轨辙到处咸宜
光明铸出千秋鉴	气冷凝成一片冰
豪情催沸千炉铁水	汗水浇开万吨钢花
玉瓶积香清泉可酿	调庭春色生涯日佳
密林深处婆娑舞	巧匠手中妙态生
穿山越岭交通无阻	乘风破浪行驶安全
渭川侯封南山劲节	淇园君子东箭奇才
水从碧玉环中去	人在苍龙背上行
一贯薪传金波生色	十分火候银冶腾辉
祖国建设蒸蒸日上	工业生产欣欣向荣
滚滚蓝炭江水电	熊熊乌金太阳能
水陆舟车四通八达	城乡客货纷至沓来
酿之太和醇醇有味	酒以言德郁郁生香
破浪乘风送君千里	浮槎泛海涉彼五湖
如琢如磨砌成碧玉	绘香绘色辉映丹墀
淡妆浓抹调新色	顽绿阁红发古香
日彩月华文成五色	云罗霞绮锦致七彩
水草精华独工点染	风萍事业定卜兴隆
九州春光添风采	科学技术改乾坤
双手盖起高楼大厦	两足踏遍地北天南
橘井泉香杏林春暖	芝田露润蓬岛花浓
喜报频频频报喜	欢心事事事心欢
一剪喜成百家愿	寸尺巧量万人心
井架刺天石油如水	钻机穿地乌金成山
向自然索取宝贵财富	为人类开出幸福源泉
金碧辉煌藻文富丽	香木雕筑花样新奇
为时代列车奠基铺路	钢花飞溅为九州织彩
机器如日月长年运转	产品似江河万里奔腾
树雄心攻克生产难关	立大志攀登科学高峰
技术革新进步更进步	科学实验成功再成功
挖掘人才开致富新路	引进技术搞名优产品
重科学爱科学用科学	树新风创新风赞新风
千锤百炼炼出工人力量	朝熔夕铸铸成团结精神
鼓拼搏雄风宏开伟业	立图强壮志振兴中华
先进帮后进日乘千里马	今年胜往年更上一层楼
江山多娇放开千里目	大厦有阶更上一层楼
效率高速度快喜报频传	劳动好贡献大红花争辉
开源节流大搞增产节约	比学赶帮掀起竞赛高潮
钢花耀云彩山河织锦	铁水腾火龙大地争春
解放思想学习先进技术	加快步伐赶上国际水平
无私无畏坚持真理树正气	有胆有识克服阻力破难关
企业自主干群意气风发	质量优先生产捷报频传
旧岁在凯歌声中载入史册	新喜于开门红里铺满阳光
创伟业群英奋起争光华夏	迎新春百花竞放斗艳古城
瑞雪飞梅花笑景色绚丽	凯歌奏捷报传战果辉煌
给民造福，可上九天揽月	为国争光，敢入四海擒龙
方便安全邮通五洲四海	迅速准确电传四面八方
机器隆隆车间盛开优质花	笑语阵阵班组齐唱胜利歌
爱厂如家养成节约习惯	奉公克己发扬艰苦精神
想当年吐绿躯巍千鸟集	观此日颜新态媚万家楼
一代风流，步伐矫健奔四化	八方志士，雄姿勃发建奇功
东西往来满载春风行千里	南北驰骋运送笑颜进万家
产销对路，多产多销多积累	质量达标，保质保量保安全
东风浩荡革命形势无限好	大地回春生产热情分外高
座座平炉，钢花飞溅传捷报	排排井架，油浪翻腾奏凯歌
大地春回祖国山川放异彩	艳阳高照中华儿女绘新图
创优革新，须知效益即生命	争分夺秒，牢记时间胜金钱
爱厂如家，提倡文明争贡献	以苦为荣，振奋精神献青春
青春比烈焰推动时代巨轮	汗水汇甘霖浇灌四化红花
改革花艳，水色山光皆诗画	建设果甜，年丰人寿尽欢歌
创新局，展宏图，集思广益	破旧规，搞改革，人尽其才
扬长避短，人尽其才，物尽其用	开源节流，取之以道，用之以时
损人有过，轻人失礼，助人高尚	败业可耻，守业无能，创业光荣
站上高处，看到远处，干在实处	懂得昨天，立足今天，奔向明天
手把焊枪，描绘宏图，焊牢经济实体	脚踏实地，发展有色，踏进改革前列
钢河、煤河、石油河，齐奏胜利凯歌	金山、银山、花果山，争绘丰收画图
袅袅白云，不尽帆飞，三峡浪开东海日	翩翩黄鹤，无边霞涌，五洲客醉楚天春
文坛香溢	艺苑花荣
胸中波澜	笔底风雪
诗情画意	琴韵书声
热诚爱国	苦心育人
资料精粹	信息总汇
云霞万影	丝竹千声
学知不足	业精于勤
钻研科学	攀登高峰
十年树木	百年树人
影坛新苗	艺苑百花
琴瑟在御	笙磐同音
画以流美	书以言情
戏有高雅	台无俗情
文生异彩	艺展新姿
风华正茂	意气方遒
韩康利薄	橘井泉甜
文章江海	书籍林泉
普及教育	振兴中华
万民康健	四海春晖
读万卷书	行万里路
祖国花朵	来日主人
聚蓄百草	平康兆民
五车图集	万轴琳琅
紫台绿帙	黄卷青箱
华佗再世	扁鹊重生
鸾笙竹管	铁板铜瑟
培育英才	钻研科学
精印文史	扬名海外
五车诗胆	八斗才雄
发扬风雅	歌舞太平
棋逢对手	将遇良才
山河一统	松雪四家
寓教于乐	动情以真
延年益寿	救死扶伤
八风从律	六吕调阳
书山觅宝	学海泛舟
叶茂披翠	花繁飘香
古为今用	推陈出新
开卷有益	温故知新
冬练三九	夏练三伏
唱时代赞歌	写人民心声
漱六经芳润	储二酉清华
一着不慎	满盘皆输
是乃仁求	必为良医
树立高风尚	培养新道德
奇文共欣赏	疑义相与析
砚生云海	笔舞龙蛇
悬壶市药	铸镜鉴邪
一代园丁乐	四时桃李荣
文坛有芳草	艺苑多奇葩
笔浮梅蕊	文凝雪花
向阳花朵	茁壮新苗
文心清若水	诗胆大如天
艺苑百花俏	文坛万象新
齐唱四化	巧绘三春
岐黄事业	菩萨心肠
图书腾风彩	文笔若龙翔
学海凭鱼跃	书林任鸟翔
绳锯木断	水滴石穿
神农尝草	岐黄典医
教育呈新貌	园丁育好苗
文坛生异彩	艺苑溢芬芳
江山助磅礴	文物照光辉
校园还春绿	桃李向阳红
残碑留古迹	妙墨焕中华
精研中外史	洞察古今情
传四海美景	映五洲英姿
求有用知识	学实际本领
东壁图书府	西园翰墨林
藏古今学术	聚中外佳作
苦读有恒	好学无时
文章千古事	风雨十年人
书法扬道义	翰墨播文明
胸中具成竹	舌底翻莲花
甬江新曲调	槐国旧衣冠
书中乾坤大	笔下天地宽
交古今善士	读中外奇书
大写英雄谱	高唱进军曲
欲知千古事	须读五车书
革古今之作	罗中外之章
谱翻新乐调	唱出大风歌
和风吹绿竹	清韵入朱弦
守四项原则	育一代新人
丹青饰山水	金碧绘楼台
弦中参妙理	曲里寄幽情
游戏一席地	艺趣万人心
二句三年得	一吟双泪流
布景开银幕	登场运铁机
勤奋出天才	实践得真知
笔力千军阵	词源万马兵
吟哦出新意	坦率见真情
推窗观天地	挥毫凌云烟
事业贵精细	文心重雕琢
诗从肺腑出	情由心血来
文章溯古迹	博物寻原宗
和声鸣盛世	雅乐协元音
同心追科学	并肩攀高峰
意飘云物外	诗人画图中
演唱今昔事	讴歌盛世情
竹院生幽静	柯山岁月长
杏林三月茂	橘井四时春
挥毫列锦绣	落纸似云烟
妙能齐尔齿	慧岂拾人牙
落笔赞五岳	成诗颂九州
苦读千年史	笑吟万家诗
独话灵芝草	当归何首乌
著书掠日短	舞剑伴星稀
园丁育桃李	雨露润禾苗
乐荐千里马	勇攀万仞峰
草香千品药	树有百年花
药香沾笔砚	波影上檐楹
寻天地行踪	觅宇宙究竟
春官桃李战	昭代岁时新
桃李满天下	雨露遍神州
良医同良相	用药如用兵
教育千古业	花红一园春
今日祖国花朵	明天建设英才
执血浇灌幼苗	忠心哺育鲜花
雄心挟雷电	壮志卷风云
不惜千金价	惟求一体仁
远求海内珍本	快读人间良书
大地江山如画	满园桃李争春
反映时代脉搏	振奋革命精神
继先烈遗志	做四有新人
以宇宙为教室	奉自然作宗师
知不足者好学	耻下问者自满
培养一代新秀	促进两个文明
株株桃李争艳	朵朵葵花向阳
发展体育运动	增强人民体质
以六书传四海	愿一刻值千金
猛跨道道难关	求索万千命脉
高唱胜利凯歌	抒发爱国深情
打开科学宝库	培养建设栋梁
忠诚教育事业	塑造美好心灵
园丁呕心沥血	桃李斗艳争奇
春风化雨润桃李	丹心育苗树栋梁
尊师爱生风尚美	勤学苦练气象新
文成蕉叶书犹绿	吟到梅花字亦香
学海无涯勤可渡	书山万仞志能攀
鲜花朵朵园丁意	硕果累累桃李情
培育祖国新花朵	抚育革命接班人
一身许国传科技	两袖新风作师表
白发喜见迎春柳	丹心笑种向阳花
养德增智强体魄	爱国尚俭近工农
神州满园桃李艳	中华遍地栋梁材
云苑喜栽新著稿	风帘闲校旧抄书
此日梓楠同受范	他年桃李广培材
攀山有志千条路	学业无心万事空
图文并茂益读者	书画同源扬国风
石刻六朝传百本	风流九代仰千秋
且喜满园桃李艳	莫悲两鬓霜雪寒
千日盼槐绽百花	一心愿笋长成林
园内桃李年年秀	校中花朵时时香
桃李园林结硕果	红专道路出贤才
春催桃李遍天下	雨润栋梁满九州
浩浩春风催桃李	孜孜园丁育栋梁
春到校园别有景	风来书案自生香
至乐无声惟孝悌	太羹有味是读书
银幕生辉百花放	舞台活跃万象新
诗无流俗形声正	字不矜张结构安
远求海内珍藏本	快读当今畅销书
人梯巧搭登攀路	心血勤浇栋梁材
传播四海新文化	推广九州有用书
长留天地无穷趣	最爱书田不老春
文坛英才挥彩笔	艺苑新秀唱颂歌
古今学术藏满架	中外精华聚一厅
万卷书中寻佳语	五线谱上觅强音
笑看文苑芳斗艳	喜听艺坛鸟争鸣
日出万言生花笔	风行四海传惠书
庭松不改青葱色	盆菊仍霏清净音
才能伴信息显现	理想随事业腾飞
静若山容仁者寿	文为国粹圣人师
科学通天前程远	知识为阶道路宽
新声谱出扬州慢	明月听来水调歌
荧窗虽小观今古	屏镜不大映乾坤
建成世上惊天业	写出人间动地诗
极尽四时之所乐	自成一家以立言
白雪阳春传雅曲	高山流水觅知音
笔舞龙飞书壮志	墨落云起赞英雄
大地山川生笔底	九州人物出毫端
挥将日月长明笔	写就雷霆不朽文
画其容惟肖惟妙	描圣像越看越神
乐引清泉浇桃李	甘洒碧血育人材
舞台演出千家暖	银幕送来万户春
一口叙述千古事	双手舞动百万兵
当头炮妙手放响	卧槽马巧计牵出
紫毫写出光明亮	宣纸画成丰收图
两手托起千秋将	孤灯照出万古人
腹藏明月描凤舞	胸有春阳笔花香
喜看祖国添锦绣	笑挥彩笔绘新图
舞台百花吐娇艳	艺苑万象展新容
纳士招贤贤于贤	选才任能能胜能
尊师重教兴美德	敬老爱幼立新风
春催桃李朵朵芳	果满枝头颗颗香
洒下园丁千滴汗	赢来花卉万般娇
笔底纵谈中外事	胸中洞彻古今情
欣逢盛世修新志	乐著文章享后人
三尺讲台连广宇	一片丹心育春苗
文章尔雅从无俗	诗赋风流自有神
脚下行程千里远	腹中书贮万卷多
斗室能观天下事	方箱可纳地球人
爱生自能受生爱	师人方得为人师
春笋破土根根好	陈泥护花朵朵香
种田选种莫随便	学子读书要认真
雅怀深得花中趣	妙虑时闻笔里香
园丁励志栽桃李	伯乐诚心荐英才
知识海洋勤是岸	科技高峰志为梯
情通三尺讲台外	志在一寸粉笔中
精雕白玉千层艳	细教英才百倍豪
齿牙何惜留余患	金玉其相具美观
一支粉笔开巨锁	满腔豪情绘宏图
巧匠呕心琢美玉	严师沥血育英才
曲尺画成方圆器	直线调就栋梁材
愿做春泥护绿李	甘当人梯架金桥
园内桃李年年艳	校中栋梁节节高
荟萃馔馐香四海	芬芳桃李遍三秦
书山有路勤为径	学海无涯苦作舟
儿童乐园无限好	祖国花朵别样红
黑发不知勤学早	白头方悔读书迟
桃李花开春天里	园丁汗洒苗圃中
饮露幼苗争绽蕊	迎春老树发新芽
科研路上无险阻	攻关阵前有能人
幼儿园内春风满	向阳花开遍地红
喜看桃李满天下	乐见新人绘山河
中外图书皆有文采	今古名言俱备精华
因材施教成早果	定向培养出好材
宝剑锋从磨砺出	梅花香自苦寒来
攻千重关心怀天下	读万卷书志在四方
祖国行行出状元	体坛处处有新星
彩笔凌云腾蛟起凤	春风化雨绽李开桃
卫星同步航天际	宝树生财遍地栽
夺冠不畏压力大	争标何惧险峰多
寸寸光阴我宜惜此	空空色相人其鉴诸
欲开科学千重锁	当破世界万卷书
指点江山春光满目	激扬文字彩笔生辉
笑看文艺群芳斗艳	喜听艺坛百鸟争鸣
艺苑百花争奇斗艳	文坛新苗战雪傲霜
采冰山雪莲不怕路险	探骊龙珠宝岂畏海深
推陈出新五光十色	百花齐放万紫千红
广采祖国各地新鲜事	播放城乡人民爱听歌
银幕映红花红花吐艳	影坛咏绿水绿水长流
文艺舞台百花齐放	教育战线万木争春
甘做园丁为祖国添秀	愿为春雨育桃李成材
红色电波传四海佳话	荧光屏幕映五洲风光
科研喜讯似春潮涌现	生产捷报如雪片飞来
艺苑乐地，五光十色	歌台舞榭，万紫千红
水滴石穿，业精不舍	海阔天高，学贵有恒
掏尽丹心谱写园丁歌	洒满汗水当好育花人
坚毅自学，博深无限	创造发明，报国有门
推崇科学笑迎百花艳	倡导文明喜看万象新
文坛映彩出多少新秀	金笔生辉写时代强音
喜看园丁辛勤一堂秀	笑谈桃李成材四海春
潜心科研，书读十载	造福人类，功在千秋
神州腾飞，科学关键	中华崛起，教育先行
辞旧岁万众高歌丰收曲	迎新春彩笔精绘四化图
发展科学，广开宝库	繁荣经济，振兴中华
祖国昌盛有赖教育振兴	四化实现须靠科技发展
跋千山涉万水寻方采药	进万户走千家治病医伤
眼观六路，分析社会动态	耳听八方，了解民众要求
春花遍地，甘做园丁勤灌溉	雪岭摩天，愿为志士勇攀登
一往无前攻克文化堡垒	百折不挠攀登科学高峰
百花齐放喜看神州铺锦绣	万众一心共挥彩笔绘新图
学海不深藏自古英才凭自励	书山须探奥从来绝顶靠人攀
八尺银幕通晓古今中外事	一盘胶带收揽天下众人心
豪杰挺生，遂今名山萦旧梦	英才乐育，犹看学生步青云
卫星上天空揭开宇宙奥秘	潜艇入水底探索海洋珍藏
妙手播春风，笺笺良方除百病	慈容祛暮霭，耿耿丹心暖万人
重德重才潜心造就新一代	管教管导全面培育接班人
古为今用，认真发掘文学宝库	推陈出新，积极扶植艺术新花
文艺舞台百花齐放朵朵争艳	学术论坛群星灿烂颗颗生辉
学海艺海能手芸芸，众星媲美	文坛诗坛英才济济，群芳争妍
一支教鞭，点开多少学生心窍	几色粉笔，描出无数科学蓝图
冲锋陷阵，攻克科学技术堡垒	争分夺秒，赶超世界先进水平
学知识，学业务，铸千秋大业	讲文明，讲礼貌，树一代新风
春风拂文坛，且喜文坛千树绽绿	红日照艺苑，更贺艺苑百花正红
彩笔传情，高歌神州大地风光好	丹霞达意，赞颂中华儿女俊杰多
科学攀高峰，沙场宿将刀未老	知识开宏宇，园圃新秀剑正锋
志于道据于德依于仁而后游于艺	修其身齐其家治其国必先正其心
天线成林，刺穿乡野千年寂寞夜	荧屏如画，收尽神州万里沸腾春
立科学志，读科学书，当科学家	说老实话，办老实事，做老实人
四体不勤，五谷不分，孰为夫子	小疑必问，大事必闻，才算学生
有志者做有志事，有志民族愈有志	文明人树文明风，文明古国更文明
格物致知深究数理化，誓达科技峰顶	勤学苦练发展德智体，定为祖国争光
学文化长知识大干四化	习武功强身体保家卫国
绿茵场上跃猛虎	碧水池中腾蛟龙
练身体练意志打出好风格	胜不骄败不馁赛出新水平
向世界纪录瞄准	为祖国人民争光
杰出健儿，翩翩小将	高超绝技，鼎鼎大名
体坛新秀创奇迹功彪青史	中华健儿立壮志威震全球
路线对政策好前程似锦	身体壮生活美诸子吉祥
大智大勇大有作为创伟业	敢拼敢搏勇夺桂冠立新功
体坛新秀朝气蓬勃绿竹吐翠	沙场战将雄风铮铮宝刀未老
学武术传技法承前启后	效先烈展宏图继往开来
运动健儿冲出亚洲誉满四海	体坛俊杰腾飞世界名扬八方
百米冲刺靠千日苦练作后盾	一朝争先有十载寒暑为前驱
炎黄子孙武精力壮犹如钢筋铁骨	华夏儿女侠肝义胆何惧虎豹狼豺
冲出亚洲中华儿女扬眉吐气	走向世界神州英杰先声夺人
赛场上红男绿女舞翩跹姿态英俊	骄阳下刀光剑影相辉映身手不凡
夺桂冠金杯中盛满辛勤汗水	攀高峰奖牌上记载奋斗历程
起死回生通妙诀	救死扶困羡良医
户户皆为清洁户	人人都是健康人
妙手回春治百病	满腔热血为人民
快刀无声除疾患	神术有情解病危
永求良药医百病	发挥妙手治千人
跋千山行医送药	涉万水救死扶伤
巧手医百病	红心暖万家
模范卫生院	生产先进家
人人爱清洁	家家讲卫生
老少喜康泰	城乡乐丰盈
病灾不染清洁地	福寿常临健康家
健康门第春常在	卫生人家庆有余
除三山五岳病痛	收四海九州精华
神农本草香千里	岐伯医学播五洲
注意卫生延年益寿	讲究科学除病去灾
入室有言皆是药	出门握手便知心
手巧心红医百病	艺高胆大治千疮
欲向市中求妙药	须知海内有奇方
发掘祖国医学宝库	保障人民身体健康
中西交流取长补短显妙手	新旧互学救死扶伤展神通
实行计划生育老少康乐	推广合作医疗人寿年丰
城乡兼顾发展保健事业	中西结合提高医疗水平
丹心妙手白衣战士除顽疾	银针草药人民医生创奇迹
讲卫生天增岁月人增寿	除疾病春满神州福满门
古今未见一人服仙丹长生不老	中外已闻万例凭锻炼益寿延年
白衣红心，舍己为人，先防再治	高术精艺，扶伤救死，妙手回春
踏群山，尝百草，废寝忘食钻业务	走千家，串万户，救死扶伤为人民
五谷丰登凭劳动得来不是靠天吃饭	四季健康赖卫生讲究何必拜佛求神
香分花上露	水汲石中泉
步月凌波去	登堂入室来
和声鸣盛世	鼓乐庆升平
挥毫刺锦绣	落纸如云烟
剪彩为歌袖	裁云做舞衣
不愁夕阳去	还有夜珠来
尝来皆适口	咽去自清心
嘉名称博士	大礼重高冠
冷暖随人意	缠绵动客心
光华能照乘	身份重连城
光照天边月	寒凝涧底泉
开源广辟财富	储蓄积累资金
云霞分五色	锦绣聚千纯
台上冰华澈	人间月影清
有材皆中选	适用乃为宜
虽云毫末技艺	却是顶上功夫
雪花资润泽	香水溢芬芳
权衡凭正直	轻重在公平
同事亲如兄弟	商店胜似家庭
乐滋滋为四化	笑盈盈迎顾客
信誉为尊	用户至上
聚沙为塔	滴水成河
一尘不染	百问不烦
物化绚彩	宫锦标奇
礼貌待客	文明经商
人和国富	时泰年丰
物质优胜	精神文明
地尽其利	货畅其流
经商有德	奉公以廉
明码实价	童叟无欺
待时而动	不叩自鸣
宏基永固	源水长流
万民便利	百货畅通
盈余得利	丰富多财
储以备用	蓄乃有余
发展生产	保障供给
堆金积玉	聚宝藏玢
琳琅满目	顾客盈门
顺受百福	隆盛四时
其器从革	终日服箱
主欢客乐	近悦远来
竭诚服务	薄利多销
惠风和畅	明月团圆
生意兴隆	财源茂盛
民殷国富	花好月圆
布衣兴国	蓝筚开山
货源恒足	品物咸亨
货流不息	宾至如归
春风满面	顾客盈门
门盈喜气	店满春风
履行平等	冠冕群伦
黄粱梦熟	白莞含烟
文明处事	买卖公平
隆声远布	兴业长新
丰财阜货	裕国富民
汇川纳海	敛福生财
价廉物美	近悦远来
万商云集	兴业日新
春阳乍暖	生意勃兴
萃集百货	丰盈八方
洛阳纸贵	上党佳珍
五谷村光	万宝告成
白疑叠雪	朱若含春
合束为柴	伐薪为炭
夏宜麻葛	冬用毛棉
素以为绚	紫不夺朱
一室珍品	千古奇观
任权钧物	嘉量平心
交流百货	信诺千金
玩此思物	具有巧思
饼名五福	糕赐重阳
陈其宋器	积有古香
云母开屏	水心铸镜
不嫌事小	但愿人乐
一店佳品	四时鲜活
金石刻画	翰墨姻缘
可取以准	勿失其时
金钗十二	珠履三千
江山如画	胜友似云
冰桃雪藕	绿橘黄橙
兴隆大业	昌裕后人
声歌盛世	乐庆丰年
蜜中露饯	千里藏鲜
一池春水	万人舒心
卧薪励志	送炭蒙思
香先传腊八	米早煮弓双
举杯邀明月	拍手歌春风
闻香须止步	知味且停车
调饴养老	食蔗回甜
入夜餐方集	交冬市更忙
清言霏玉屑	洁白类银丝
酒香留客住	诗好带风吟
轻裘被服	罗绮生香
味涵玉液	美比琼浆
金钱善贾	聚米为山
巧做百家菜	喜迎四方客
生财有大道	信用得中孚
光浮竹叶翠	色借郁金黄
广开生财道	大念致富经
楼观沧海日	地傍小安沙
小费君莫惜	后顾自无忧
存小额金币	作大块文章
物美销路广	价廉称客心
三江待茶客	四海迎春风
为生产服务	作致富后勤
巧理千家事	温暖万人心
多想生财道	广开致富门
汲取甘泉水	供应幸福人
缓急人常有	权衡我岂无
春共山中采	香宜竹里煎
煮沸三江水	同饮五岳茶
清风洒六合	和泽周三春
滴水汇大海	垒士积高山
牛羊夸茁壮	鸡鸭善烹调
节资须刻苦	储蓄贵有恒
讲商业道德	树财贸新风
环绕生财地	祥开造福门
柜台春风暖	商店百货全
迎年须早备	祝寿更相宜
茶香飘四海	叶味流三江
夏虫不可语	风雅独绝伦
清真有美味	热情待佳宾
店好千家颂	坛开百里香
烹煮三鲜美	调和五味香
光明凝似雪	色泽滑于油
青山沐雨露	闹市献清香
春江取不尽	秋水竞自来
池中常蓄水	亭下自通泉
皎洁如凝雪	晶莹似结冰
浑圆得天体	包藏无物形
接八方贵客	迎四海亲人
五味甘能配	四时用不穷
相逢皆萍水	小住息风尘
架上图书润	室内翰墨香
金穰称国宝	玉粒济民生
阳和蒸土脉	未捻庆年华
春城欣百业	花市拥群芳
墨花飞紫露	笔阵起雄风
洗甲天河静	染衣柳汁新
物未龙鳞化	品同熊掌珍
匠心随所欲	着手便成春
柳枝初分绿	桃花相映红
未登瑶池宴	已成蟠桃仙
共谈天下事	相看万里宾
青山收笔底	绿水涌毫端
事业传清白	生涯在水乡
频劳工匠巧	博得众人欢
花开群芳谱	鸟唱迎宾曲
六书传四海	一刻值千金
厚生资利用	和众兆丰财
层楼尽瑰宝	满堂皆珍奇
琴书多古意	水石澹幽居
云霞成异彩	兰桂起香风
点心甜万户	佳酿醉千家
心怀四化大业	身站三尺柜台
进门都是顾客	到此即为亲人
羊革狐裘新样	御寒莫错机缘
洗掉全部污垢	增添一身豪情
经商斤两不克	办店老少无欺
活跃集市贸易	沟通物资交流
保证市场供应	满足群众需要
他乡故国虽千里	芳草奇花总一春
瓶中色映葡萄紫	瓮里香浮竹叶青
交以道接以礼	近者悦远者来
祖国天涯同梓里	神州海角遍亲人
翠叶烟腾冰碗碧	绿芽光照玉瓯青
五味烹调香千里	三鲜蒸炸乐万家
味超玉液琼浆外	巧在燃箕煮豆中
日暖冰融春光美	鸡鸣鸭舞喜事多
多把芳菲汛春酒	已见沧海为桑田
一年常有时令菜	四季不乏地头鲜
饭菜誉满三江水	情意饱暖四海心
满面春风顾客喜	贴心服务饭菜香
美品珍逾茭白鲊	春风香送杏花饴
生意兴隆通四海	风味佳美誉三秦
美酒佳肴迎挚友	名楼雅座待明朋
斤两不失一刀准	肥瘦可匀千客夸
仙果赐来人益寿	珍盘纷列客尝新
五湖四海宾朋至	一日三餐饭菜香
一秤深情千家乐	满店蔬菜四季鲜
水如碧玉山如黛	酒满金杯月满楼
东风利市春来有象	生意兴隆日进无疆
竹叶杯中春有色	杏花村里客多情
茶余喜谈致富事	酒店倍增创业心
送货上门方便群众	摆摊设点服务人民
窗外看山风生七碗	楼头近水春满一壶
春满柜台五光十色	货盈橱架万紫千红
味美招来天下客	酒香引出洞中仙
以三尺柜台为岗位	待八方顾客如亲人
喜迎笑送来去高兴	东拣西挑买卖公平
店有名名扬四海	饭喷香香飘五洲
货架上下鲜花朵朵	柜台内外春意融融
顾客如川川流不息	生财有道道畅无穷
饭熟菜香春满座	窗明几净客如云
百货百美百看不厌	千客千心千选不烦
联合经营互惠互利	热情服务全心全意
一川风月留酣饮	万里山河尽浩歌
百问不烦百看不厌	笑容常展笑口常开
开源节流为民着想	集资创汇替国分忧
主甜客甜心更甜	饭香菜香汤也香
方圆厚薄甜咸各具	味美色香精细齐全
服务周到群众满意	态度和蔼顾客称心
笑语带书香英花发外	经营怀古道和顺积中
自古无先知谁能免祸	而今有保险我可救灾
生意意中生生财有道	买卖卖后买买卖兴隆
丰收须节俭利公利己	富裕当储蓄益国益民
党风民风社会风气好	天新地新服务面貌新
门前大道通八方利路	店后小溪纳四方财源
三尺柜台招四方顾客	一腔情意拂二月春风
诚信无欺，言如九鼎	寄托为重，诺此千金
喜事业兴隆万民得利	看分秒准确为国惜时
精心理财绘四化美景	妙手运筹奏九州乐章
尽力开源，资财不竭	厉行节约，周转有余
千百万户户户皆是储户	七十二行行行不离银行
盘浅情浓味适佳宾口	物美价廉甜透贵客心
利己利人君子生财大道	公心公物哲人处世良方
饭热汤热八方客常暖	菜香酒香四季店如春
去去来来人人欢欢喜喜	多多少少日日取取存存
银行用热情服务用户	人民以存款支援国家
收入开源，远浪大涛滚滚	支出把口，长流细水潺潺
东西南北客人人满意	春夏秋冬货样样称心
拨响算珠乐为改革谱新曲	清点资金甘帮致富奏凯歌
福星不照懒惰户福星有限	财神偏爱勤劳人财神多情
以公仆态度对人，人人满意	按经济规律办事，事事称心
办好信贷，大力支援建设	开展储蓄，多方积累资金
发展生产，百业共百花并茂	繁荣经济，万民与万物同春
鼓励储蓄活期定期各自便	欢迎户主存款取款常往来
广开资源，财似造山千篑少	畅通渠道，物随人意四方流
有蒸饺，有汤饺，随时可供三餐饱	泡清茶，泡香茶，请君更上一层楼
管国家资金，赤胆忠心，一身正气	办人民储蓄，鞠躬尽瘁，两袖清风
讲文明讲礼貌任劳任怨使群众满意	讲政策讲信誉保质保量让人民称心
集龙城山珍野味，制佳肴迎来仙客	得瑶池玉露琼浆，酌美酿醉卧华楼
产品新，质量高，生意兴隆通四海	信息灵，商路广，财源茂盛达三江
子年人瑞	丙岁春温
子为地支首	鼠乃生肖先
豕去呈丰稔	鼠来报吉祥
鼠为生肖首	春乃岁时先
丙年兴旺	子民腾欢
子夜为鼠	丑时属牛
子夜钟声响	鼠年爆竹喧
春燕鸣暖树	金鼠跃青枝
丙年风仪	子夜钟鸣
苍松随岁古	子鼠与年新
碧野青蛙叫	黄山松鼠鸣
欣有鼠须笔	喜题燕尾书
丙名世德	子夜凯旋
子夜岁交替	鼠年春更新
黄莺鸣翠柳	金鼠恋苍松
黄山松鼠跳	绿野甲春归
子孙奋发	丙火辉煌
豕去春无限	鼠来岁有余
春风拂柳绿	灵鼠跳松青
新妆鼠嫁女	美景燕迎春
祖国健儿兴骏业	鼠须彩笔绘宏图
子夜佳章茅盾著	鼠偷奇案况钟察
壬遇深思心谢党	子图大业力描春
子时春意闹	鼠岁笑声甜
鼠至调新律	鸡鸣报早春
鼠来豕去远	春到景更新
子夜松涛劲	鼠年鹊语香
鹊语红梅放	鼠年喜年浓
粮多衣食足	子尽旭日升
百年推甲子	福地在春申
春潮传喜讯	鼠岁报佳音
鼠年吉星高照	猪岁捷报频传
一日时辰子为首	十二生肖鼠占头
龙国群英兴伟业	鼠须彩笔绘蓝图
银花火树迎金鼠	海味山珍列玉盘
未有吉言托老鼠	敢将套语贺新春
年画喜人鼠嫁女	红梅傲雪鹊鸣春
万千禽兽尊为子	十二生肖独占先
吉祥鼠报丰收岁	科技花开富裕家
子夜钟声燃爆竹	鼠年古语化春联
肃贪惩治官仓鼠	正本当纠裙带风
子夜鼠欢爆竹乐	门庭燕舞笑声喧
灵鼠迎春春色好	金鸡报晓晓光新
务本神农播百谷	刺贪硕鼠吟三章
子时一到开新律	鼠岁三春报好音
银花万簇迎金鼠	火树千株展玉龙
灵鼠跳枝月影晃	春牛犁地谷生香
才见肥猪财拱户	又迎金鼠福临门
春鼓频敲鼠嫁女	秧歌竞扭喜盈门
麟角凤毛增国誉	鼠须妙笔点春光
窗花巧剪吉祥鼠	科技尊称致富神
鼠无大小名称老	年接尾头岁更新
宰掉肥猪开美宴	迎来金鼠庆新春
莺歌燕舞春添喜	豕去鼠来景焕新
甲第连云欣发展	子年遍地祝丰隆
老鼠娶亲鸣鼓乐	羊毫蘸墨写春联
鹊喳梅放春迎户	鼠报年来福满门
金鼠临春粮增财旺	银豕辞岁言壮禽肥
花香鸟语春光好	雨顺风调稻菽丰
老鼠娶亲成故事	雄鸡迎日报新春
稻菽千重金浪起	春风万里玉梅开
春雨晓风花开五色	鼠须麟角力扫千军
子鼠一点红补气利水称良药	亥猪三大盆营养丰盛是佳肴
一纪开端共迎金鼠	三春肇始同举玉杯
豕岁又是丰收高高兴兴送去	鼠年更为繁荣欢欢喜喜迎来
豕去鼠来新换旧	星移斗转腊迎春
鼠年大吉大利一切试验皆成功	猪岁捷报捷传各个领域均凯旋
愿效老牛	为国捐躯
牛耕绿野	虎啸青山
牛如南山虎	马似北海龙
春暖青牛跃	山高碧水流
牵牛花报喜	布谷鸟催春
黄牛耕沃野	紫气茏新春
紫燕寻旧主	金牛闹新春
丑时春入户	牛岁福临门
人逢如意事	牛舞艳阳春
春新牛得草	世盛国增辉
愿效黄牛力	尽抒赤子情
客岁送金鼠	今年买铁牛
得失塞翁马	襟怀孺子牛
金牛奔盛世	紫燕舞新春
岁首春到户	牛年福满门
牛耕芳草地	鹊报吉祥年
牛舞丰收岁	鸟鸣幸福春
鼠遁春风至	牛携喜气来
草发黄牛乐	春新紫燕歌
深恩红赤日	忠实老黄牛
丰稔黄牛志	富强赤子心
春丽牛逢草	月明马识途
黄牛耕九野	白马战疆场
牛铃飘翠岭	燕语暖春风
牛耕千野绿	鹊闹一庭春
欢度新春节	高歌小放牛
黄牛耕绿野	猛虎啸青山
春来紫燕舞	节到黄牛忙
春催布谷鸟	人效拓荒牛
布谷迎春叫	牵牛接福来
夜草能肥马	生刍可壮牛
牛开丰稔景	燕舞艳阳天
草绿黄牛卧	松青白鹤栖
将军爱战马	农夫喜黄牛
人物风流心向党	黄牛勤奋力耕田
牧草丛中春色美	放牛曲里笑声甜
铁牛拖出满山宝	茧手挖来遍地金
为民当效黄牛力	报图壮怀赤子心
玉碗生光辉琥珀	金牛焕彩耀星辰
人勤一世千川绿	牛奋四蹄万顷黄
翠柳迎春千里绿	黄牛耕地万山金
有福人家牛报喜	无边春色燕衔来
牛奔马跃行千里	凤舞龙飞上九霄
碧树红楼相掩映	黄牛骏马共迎春
布谷鸟鸣忙布谷	牵牛花绽喜牵牛
爆竹喧天传喜庆	黄牛犁地播丰收
蹄奋不须鞭震耳	牛勤何用月当头
牛耕沃野千山笑	雪映红梅小院香
写完福字描春字	迎到金牛买铁牛
金牛开出丰收景	喜鹊衔来幸福春
牛年喜奏丰年乐	入世笑迎盛世春
当年禹甸多铜马	今日春郊遍铁牛
春到人间新燕舞	喜盈门第铁牛忙
可染画牛牛得草	悲鸿放马马扬鞭
茧花绽放漫山绿	牛背飘来一曲歌
黄土田间牛作画	紫微春苑燕吟诗
老牛力尽丹心在	志士年衰赤胆悬
碧桃无意随春水	黄犊有情鼓绿涛
良策善政多俊杰	乳牛老骥竞风流
鼠去牛来闻虎啸	民殷国富盼龙飞
万里征程初试马	百年伟业乐为牛
九州春色来天地	四化豪光射斗牛
有庆年头牛得草	无垠大道马扬蹄
春归大地黄牛跃	福到人间紫燕飞
绿柳摇风燕织锦	红桃沐雨牛耕春
勇当改革排头雁	甘作人民孺子牛
诚心乐作人间事	俯首甘为孺子牛
红梅傲雪千门福	碧野放牛五谷丰
黄牛吃草生新奶	紫燕衔泥筑小巢
花木逢春枝叶茂	牛羊得草体膘肥
人寿年丰农家乐	地肥水美春牛歌
数声柳笛飘牛背	无限春光亮马蹄
春临门户白雪化	福降人间黄牛忙
新春乐咏黄牛颂	小院频传喜鹊歌
碧野黄牛春日景	红灯绿酒丽人年
铁牛喘月平畴绿	赤帜啸风满地红
川原蝶舞翩翩好	田野牛耕户户忙
鼠去牛来辞旧岁	龙飞凤舞庆明时
户户厌恶大硕鼠	家家喜爱老黄牛
数声牧笛传新曲	四野耕犁试早春
未许田文轻策马	愿闻老子再骑牛
神州天外不放彩	农户有牛喜迎春
金牛奋蹄开锦绣	乳虎添翼会风云
年丰人寿家家乐	春到花开处处耕
五岭莺歌又燕舞	九州马叫并牛欢
一曲牧歌传牛背	无边柳色绿村头
新岁牧歌需纵酒	黄牛奋进不着鞭
腊梅花放雪将尽	春水温升牛甚忙
猪肥牛壮家增福	食足衣丰民自安
花开江左白雪尽	春到人间黄牛忙
土生白玉牛羊壮	地产黄金鸡犬欢
不知索取只知奉献	勿问收获但问耕耘
新村喜盼铁牛到	农家笑望春燕飞
金牛回春大地聚秀	红日放彩满门增辉
牛肥马壮山村添生气	人杰地灵门户沐春风
天复三阳群芳吐蕊	牛耕千项五谷飘香
牛年出牛劲劲大无比所向告捷	虎岁抖虎威威力无穷出师大吉
腊尽春归山村添喜气	牛肥马壮门户浴春风
龙吟国瑞	雪兆年丰
山月流古雪	风虎浴清泉
云中龙虎将	天上凤凰鸟
龙兴华夏	燕舞阳春
凤鸣盛世	龙有传人
事事都如意	虎虎有生气
密林藏伏虎	萝峰染晴云
龙腾虎啸	腊尽春回
高崖伏虎啸	茅庐卧龙吟
虎气冲星斗	春光艳锦霞
虎胆英雄气	龙魄志士心
春天春起色	虎岁虎生威
龙引千江水	虎越万重山
时来花作雨	春到虎追风
英雄生虎胆	祖国振龙威
忠诚牛品格	奋勇虎精神
一年春作首	百兽虎为王
虎年增国力	鸟语唱春光
寅时呈晓色	虎岁振威风
泉冽流松韵	山高壮虎威
山风惊猛虎	海浪助蛟龙
承牛年好运	展虎岁鸿猷
岁岁平安日	虎虎正气春
虎啸山增色	人欢岁更新
山鹰瞻远景	猛虎跃奇峰
春风刚入户	虎气又临门
黄牛辞旧岁	乳虎报新春
泉流飞月色	虎啸鼓松涛
山青借水秀	虎啸伴龙吟
四季春为首	群山虎作王
虎啸天边月	鹤栖石上松
辞旧怀牛劲	迎新振虎威
飞燕衔泥俏	猛虎下山雄
虎啸众山伟	春来万木荣
虎跃山河壮	龙吟日月新
侧耳松涛远	凝眸虎气生
牛舞丰收景	虎奔锦绣程
虎啸冲霄汉	龙吟震海天
虎猛山威抖	民强国力雄
新春迎大吉	猛虎跃高峰
柳营春试马	虎帐夜谈兵
虎牵新岁月	人改旧乾坤
虎啸龙吟势	松风竹韵神
牛乘捷报去	虎挟雄风来
牛耕芳草地	虎啸艳阳天
放眼呈新貌	迎春现虎威
虎猛傍山势	春浓染水香
骑牛踏雪去	跨虎报春来
道祖骑牛去	赵公跨虎来
宏谋抒虎啸	士气奋鹰扬
虎兆中兴瑞	国趋鼎盛昌
山岚呈虎性	春色暖人心
龙腾虎跃人间乐	鸟语花香天下春
处处虎跃山河壮	年年龙腾日月新
春节乍闻春有喜	虎年乐见虎生风
乾坤日月祥光照	龙虎风云瑞气生
一统山河腾龙日	三春岁月入虎年
人效黄牛心自贵	岁朝猛虎志冲天
中华虎年虎添翼	神州龙骧龙腾空
牛肥马壮辞牛岁	虎跃龙腾迎虎年
巨龙腾空中华志	猛虎啸壑民族威
丑旧寅新宏图展	牛归虎跃春意浓
虎踞龙盘今胜昔	花香鸟语旧更新
兴伟业仍须牛劲	展宏图更壮虎威
虎踞龙盘中华瑞	燕舞莺歌大地春
华夏虎年虎添翼	神州春日春映晖
虎跃龙腾生紫气	风调雨顺兆丰年
虎气频催翻旧景	春风浩荡著新篇
啸一声惊天动地	睁双眼照耀乾坤
丑去寅来千里锦	牛奔虎啸九州春
虎啸密林风万壑	鹤眠苍松月千岩
一代英豪生虎气	三春杨柳动莺歌
门浴春风梅吐艳	户生虎气鸟争鸣
虎啸一声山海动	龙腾三界吉祥来
皆称飞虎一身胆	不负英雄千古名
人间喜庆康平世	虎岁承欢幸福春
致富脱贫添虎翼	开山治水展鹏程
人民气魄如龙虎	祖国江山似画图
门庭虎踞平安岁	柳浪鸳歌锦绣春
长白虎啸林中日	江南猿啼岭上风
牛奋四蹄开锦绣	虎添双翼会风云
迎春节莺歌遍地	兴中华虎劲冲天
人入虎年增虎劲	门添春色发春辉
年逢寅虎群情奋	岁别丑牛大地春
人添志气虎添翼	雪舞丰年燕舞春
百尺飞泉鸣震谷	一声长啸势惊天
千载难逢新世纪	万民谱写虎春秋
虎啸大山山献宝	龙腾祖国国扬威
龙腾虎跃人间景	鸟语花香天地春
牛耕沃野扬长去	虎啸群山大步来
虎添双翼前程远	国展宏图事业新
四海三江春气息	千家万户虎精神
江山秀丽春增色	事业辉煌虎更威
新年捷报虎添翼	大路朝阳马奋蹄
金牛昂首高歌去	玉虎迎春敛福来
四海笙歌迎虎岁	九州英杰跃鹏程
春风着意随人愿	虎气生威壮国魂
宅后青山金虎踞	门前绿水玉龙盘
花事才逢花好日	虎年更有虎威风
黄牛虽去精神在	猛虎初来气象新
赤县奔腾如虎跃	神州崛起似龙飞
英雄时代英雄业	龙虎精神龙虎年
惟大英雄能伏虎	是真俊杰敢擒龙
虎步奔腾开胜景	春风浩荡展鸿图
春雷巨响山河动	月夜旋风草木飞
牛奔福地普天献瑞	虎卧华堂满院生辉
虎年赢得春风意	喜讯唤来燕子情
紫气东来江山如画	红旗招展龙虎扬威
金牛辞岁寒风尽	白虎迎春喜气来
虎跃龙腾九州焕彩	风调雨顺五谷丰登
祖国富强神龙活虎	人民幸福舞燕飞莺
白虎替青牛招财进宝	黄鸳鸣翠柳辞旧迎新
迎虎年英勇当似下山虎	辞牛岁踏实应如老黄牛
金牛辞旧携凯歌而去	乳虎迎春带捷报而来
虎跃龙腾一代英雄造时势	山明水秀万里春色泛桃花
岁月逢春山河添锦绣	人民思治龙虎振精神
虎跃龙腾碧海黄山妆玉宇	莺歌燕舞春风丽日蔚神州
花团锦簇江山添异彩	虎啸龙吟华夏壮神威
虎跃龙腾华夏人民多俊杰	莺歌燕舞阳春山水尽朝晖
瑞雪兆丰年年年大吉	丑牛接寅虎虎虎生威
寅时入虎年十亿人民振虎劲	佳节描春色九州大地荡春潮
虎跃龙腾创人间奇迹	莺歌燕舞描大地春光
迎新春处处呈文明气象	入虎岁人人当改革先锋
祖国腾飞大鹏振羽翼	宏图再展乳虎显神通
虎年鼓虎劲攻关夺隘皆如虎	春节焕春光绣水描山总是春
庆虎岁把酒高吟虎跃曲	祝丰年扶犁又唱丰收谣
栽竹栽松，竹隐凤凰松隐鹤	培山培水，山藏虎豹水藏龙
兔归月影笑	花绽春光妍
金鸡迎曙色	玉兔揽春光
丁年歌盛世	卯兔耀中华
红梅香小院	玉兔下人间
虎啸青山秀	兔奔碧野宽
清溪吟雅韵	玉兔洒春晖
红梅迎岁笑	玉兔伴娥欢
玉兔蟾宫笑	红梅五岭香
虎跃前程去	兔携好运来
红梅迎春笑	玉兔出月欢
耕田能获宝	养兔不守株
卯门生紫气	兔岁报新春
虎威惊盛世	兔翰绘新春
雪消狮子瘦	月满兔儿肥
玉兔迎春到	红梅祝福来
虎去犹存猛劲	兔来更显奇才
金鸡争唱晓	玉兔喜迎春
玉兔迎春至	黄莺报喜来
春自卯时报起	福由兔口衔来
虎去雄风在	兔来喜气浓
蟾宫降玉兔	庭院绽红梅
虎声传捷报	兔影抖春晖
虎振雄风留浩气	兔迎盛世蔚新春
玉兔欢奔芳草地	金乌腾跃碧云天
金虎归山去	玉兔迎春来
春自寒梅报起	年从玉兔迎来
红梅迎雪放	玉兔踏春来
虎走三关鸡报晓	兔升九域鹿鸣春
岁首喜看玉兔跃	耳边犹有金龙吟
虎岁痛饮祝捷酒	兔年怒放报春花
月里嫦娥舒袖舞	人间玉兔报春来
玉兔报春田野绿	金鸡唱晓艳阳红
虎奔千里留雄劲	兔进万家报吉祥
虎过关山添活力	兔攀月桂浴春辉
月中玉兔下凡界	陌上金鸡报晓春
虎年一去春风暖	兔岁乍来喜气浓
艳阳高照门庭瑞	玉兔喜临世纪新
庆玉兔今年奋起	视金龙明日腾飞
虎岁扬威兴骏业	兔毫着彩绘宏图
玉兔迎春春入户	金莺报喜喜盈门
东风放虎归山去	明月探春引兔来
虎去雄风镇五岳	兔生瑞气秀三春
喜玉兔今年奋起	祝巨龙明岁腾飞
喜兔年初开春色	继虎岁再展宏图
虎越雄关踪影去	兔临春境晓光新
虎啸群山辞旧岁	兔奔匝地庆新春
玉兔机灵承虎气	金乌活跃显狮威
虎尾回头添胜利	兔毫扎笔写风流
深山虎啸雄风在	绿野兔奔美景来
东方日出金乌艳	除夕月升玉兔皎
金杯醉酒乾坤大	玉兔迎春岁月新
兔奔千里传春信	龙起九霄壮国威
山中虎啸昌新运	月里兔欢启宏图
兔镜常圆人盼好	龙甲时耀国期安
玉兔毫光生紫气	金龙捷足入青云
门户临风迎春入	高楼触月接兔归
虎去雄风惊五岳	兔开健步跃三江
兔跃千山传喜讯	龙腾万里展英才
玉户临风迎兔入	高楼揽月接春来
日暖神州春辉万里	兔回大地气象一新
卯时美景花方艳	兔岁良辰酒更醇
春归月殿钟催玉兔	誉满中华鼓舞金龙
常在蟾宫攀桂树	今临禹甸送丰年
送虎岁共庆山河壮	迎兔年齐歌业绩新
送金虎，硕果丰收千里艳	迎玉兔，宏图再展万年青
春回大地百花吐艳	兔跃青山万物生辉
兔岁初临健步已驰千里	虎年虽去雄风犹镇八方
兔岁来矣劝君记取龟兔教训	虎年去也祝您发扬龙虎精神
送虎岁盈盈硕果山村景	迎兔年丽丽宏图祖国春
爆竹辞旧岁玉兔毫毛生紫气	华灯迎新春金龙捷足入青云
北斗回寅万户金鸡争唱晓	东风送暖九霄玉兔喜迎春
喜今朝，玉兔欢跃九州生色	望明岁，金龙奋起万里腾飞
玉兔出宫倾慕人间春色美	金龙潜海畅游祖国江山娇
虎岁三十，爆竹声声辞旧岁	兔年初一，红联对对迎新年
旷原驯烈马	大海潜蛟龙
蟾宫招兔去	新纪引龙飞
九天大鹏飞	四化巨龙腾
凤鸣春日晓	龙起海天高
水摇龙影动	春到燕歌新
英雄扬虎魄	华夏振龙威
新年兴骏业	盛世起龙图
春日春浩荡	龙年龙腾飞
万方春浩荡	四海龙腾飞
丹青描锦绣	翰墨舞龙蛇
辰时龙起舞	春日燕翻飞
长空排雁阵	大海起龙图
纵情挥笔墨	放胆舞龙蛇
挥笔龙蛇走	迎春莺燕歌
笙歌辞兔岁	鞭炮接龙年
神龙腾世纪	猛虎镇乾坤
神龙开盛纪	飞马跃前程
巨龙腾盛世	乳燕报新春
龙舞长城雪	燕鸣北国春
人展鲲鹏志	国呈龙虎姿
龙年春烂漫	华夏业辉煌
浪打龙宫鼓	风敲月下门
龙年呈龙瑞	春节溢春光
铭心登虎榜	立志跃龙门
白鹤松间舞	苍龙海宇游
瑞雪酿春酒	神龙展壮猷
浪高龙出海	云淡雁横秋
云飞翔瑞凤	雷震起渊龙
龙腾云似海	燕舞景长春
破壁神龙舞	迎春紫燕飞
兔辞玉乾坤	龙腾花世界
神龙腾碧海	仙鹤上青霄
丹青紫燕舞	翰墨白龙吟
海为龙世界	云是鹤家乡
龙吟春正好	燕语日初长
腊尽蛟龙跃	春归莺燕忙
江山助磅礴	龙虎壮精神
喜庆龙年好	欢歌国运昌
爆竹惊天乐	神龙振国威
猛虎惊山魄	神龙振国威
龙腾翻巨浪	虎啸动春雷
千古龙蟠虎踞	三春燕舞莺歌
桃李九州馥郁	蛟龙四海腾飞
世纪更新伊始	神龙翘首飞来
润笔观凤舞	泼墨化龙飞
大展鲲鹏羽翼	壮怀龙马精神
白昼云霞孤鹤	深山风雨卧龙
翰墨龙蛇起舞	春光莺燕翻飞
一元复始龙增岁	万物生辉燕报春
九州日丽迎新纪	四海龙吟乐大年
大治凤鸣尤悦耳	小康龙舞更开心
九天揽月中华志	四海腾龙民族魂
一代龙人开盛纪	九州大地起宏图
千家福气金龙降	万里春光紫燕衔
海上神龙跃起	梅梢春信初来
七彩云霞铺锦绣	一池翰墨舞龙蛇
世纪春光辉大地	江山国色舞神龙
人心向党人承福	国步腾龙国更强
千里云霞辉大地	万般气象壮龙年
中华民族龙传世	百鸟成群凤向阳
人心思治江山固	国步腾龙世纪新
八面威风增国力	九州春色启龙年
天地神龙开盛纪	人间紫燕舞新春
一片惊涛龙出海	八方锦绣燕衔春
九州骨肉同龙脉	两岸山河共月圆
云近紫台龙虎气	春回青苑凤麟游
风来松度龙吟曲	雨过庭余鸟迹书
千秋事业神龙舞	一代风流骏马驰
龙从百丈潭中起	春自千重锦上来
大业功成惊世界	巨龙飞跃盛中华
才闻兔岁凯旋曲	又唱龙年祝福歌
龙步青云酬壮志	鹏飞碧宇览神州
丹霞瑰丽神龙舞	大路康庄骏马驰
龙门丽景催鱼跃	祖国宏图任我描
中华儿女鲲鹏志	祖国江山龙虎姿
千寻凤阁攀云上	五色龙江抱日流
云龙上下驰东野	雪鹤飞扬入北山
万里春风苏绿野	八方喜雨起苍龙
中华振兴巨龙舞	大地焕然万象新
风发龙门春浪暖	日临雁塔晓云开
玉兔呈祥家家乐	金龙兆福步步高
中华跃日神龙舞	大地迎春紫燕飞
玉兔升腾蟾阙里	金龙飞舞彩云间
世纪风云龙际会	春风杨柳燕剪裁
云灵化鹤人增寿	海啸腾龙国有威
丹凤朝阳歌盛世	苍龙布雨润神州
龙腾云海国昌盛	春满人间民泰安
日丽三江金凤舞	虹飞五岳巨龙腾
玉兔呈欢辞旧岁	神龙跃起展鸿猷
龙门一跳迎新岁	燕子双飞报好音
龙腾霄汉开新宇	鹊立梅梢报福音
四海龙腾抒壮志	千山虎啸振雄风
两袖清风龙虎惧	一身正气鬼神惊
世纪图腾龙翅首	中华崛起国扬眉
江山依旧龙盘踞	世纪更新国富强
报春乐曲神龙咏	强国宏图众手描
龙腾虎跃闹春意	人寿年丰谢党恩
出海神龙开世纪	挥毫妙笔颂春秋
江山故国堪留鹤	华夏蓝天可腾龙
龙游沧海江湖小	狮醒神州世界惊
龙腾虎跃风云壮	物阜年丰国运昌
民族振兴增国力	中华崛起赖龙人
鸟鸣春日惊山水	鱼跃龙门动地天
江河湖海凭龙跃	山岳峰峦任虎行
世纪更新龙出海	春光焕彩燕衔泥
龙腾伟业超千古	鹏舞雄姿搏九霄
刚唱兔年歌一曲	又饮龙岁酒三杯
民情雀跃符民意	国步龙腾壮国威
苍龙半挂秦川雨	石马长嘶汉苑风
辰日一轮驰浩宇	龙年百业壮中华
欣看大地千重秀	笑望巨龙四海飞
龙岁迎来新世纪	莺歌唱出好春光
花柳春风催燕舞	英雄祖国盼龙飞
江山秀丽神龙舞	道路逶迤骏马飞
如意春风催虎啸	吉祥云彩壮龙腾
明山卧虎吉祥地	丽水腾龙锦绣程
春雨多情绿大地	金龙展志壮神州
快抓良机辞兔岁	欣承国运展龙图
挥毫凤舞千山秀	泼墨龙飞万水腾
金龙闹海春潮涌	喜鹊登枝福韵高
动地惊天龙气象	锦山绣水凤文章
春日春风春浩荡	龙年龙岁龙腾飞
兔毫描绘江山画	龙目乐观世纪春
青云浩气腾龙步	捷报宏图振国威
诗画满园铺锦绣	风雷动地走龙蛇
春节迎来春气象	龙年抖擞龙精神
旭日东升丹凤舞	中华崛起巨龙飞
鱼跃鸢飞惊海宇	龙吟虎啸咤风云
刻翠裁红新格调	屠龙刺虎好文章
英雄自有凌云志	时代呼唤潜海龙
金龙出海迎新岁	彩凤朝阳贺小康
学海潮头龙影动	书山路上凤声高
送玉兔吴刚捧酒	驾金龙敖广献珠
幸福家庭龙虎卧	文明宅第子孙贤
春光明媚江山上	龙虎腾飞事业中
金龙报春春风暖	铁手造福福气浓
指点江山扬国粹	笔挥风雨走蛟龙
笔架山高才气现	砚池水满墨龙飞
海阔何愁龙跃水	山高岂妒凤朝阳
黄龙行雨腾沧海	紫凤驾云上碧霄
火树银花明盛世	龙腾狮舞闹新春
浪翻南海潜龙至	风振紫霄翔凤归
凤鸣盛世前程锦	龙有传人中华兴
国策英明增国力	龙年飞跃展龙图
蛟龙腾海风雷激	莺燕闹春杨柳青
万里春华开锦绣	九州龙虎会风云
苍梧拔地栖金凤	碧海连天潜玉龙
梅为小院添春色	鹊向龙年报好音
梅柳三春飞雏燕	炎黄一脉是神龙
华夏巨龙腾玉宇	东方雄狮震乾坤
装点江山凭妙手	更新世纪在龙年
九龙飞舞千秋雪	百鸟啼啭万树花
紫薇祥气腾龙态	伟业宏图壮国威
喜报人间曾伏虎	新开世纪正腾龙
十亿神州春日起	千秋华夏巨龙飞
玉兔欢跃锦绣地	金龙飞腾艳阳天
蛟龙出海迎红日	紫燕归门报早春
龙启吉祥云蒸霞蔚	花开富贵人寿年丰
龙的传人强邦富国	春之使者润土丰年
彩凤来仪迎大治	金龙起舞庆新春
旭日乐升雄狮吼	中华崛起巨龙腾
九州日丽迎新政	四海龙吟乐胜年
梅花香遍神州地	龙步震开盛纪春
玉兔升腾月殿去	金龙飞舞人间来
笔走神龙凭大手	诗流雅韵有高人
岁降金龙蒙化雨	年逢惠政沐春风
龙腾华夏金鼙壮	春暖虞唐草木荣
龙上高天凤翔远树	春盈大地花漫神州
无边春色来天地	有志金龙越古今
大地春回凤鸣盛世	中华崛起龙有传人
一柱擎天九龙腾跃	八仙过海五岳欢歌
国运国兴凭国策	龙飞龙跃靠龙人
大业中兴宏图再展	神龙起舞祖国长春
齐奔四化雄师竞舞	振兴中华巨龙腾飞
虎啸无弦惊海宇	龙吟有意动河山
凤质龙文光华相映	景风淑气仁寿同登
四海英才龙腾虎跃	千秋大业霞蔚云蒸
三春花雨播龙种	十亿神州起凤毛
紫燕飞来寻玉兔	黄鹏唱起戏金龙
万水千山凭虎跃	五湖四海任龙腾
四柱擎天九龙腾跃	八仙过海百姓安康
美酒千樽欢送玉兔归山	赞歌万首喜迎金龙出海
四柱擎天看神州巨变	五星焕彩引玉龙腾飞
东海跃明珠金龙献岁	南天开淑景俊鸟鸣春
喜气满庭阶春来福地	凯歌传江海鱼跃龙门
龙子龙孙龙年会龙潭	虎头虎脑虎气生虎威
起凤腾龙千家争贡献	移山填海十亿尽风流
天下皆春长街喜看龙灯舞	人间改岁小院欣闻爆竹鸣
金凤舞蓝天欢歌盛世	玉龙回大地喜贺丰年
华夏腾飞时势造就新业绩	巨龙昂首英雄独领好风骚
大地绽新绿欢送兔岁	长空鼓春风喜迎龙年
为国争光可上九天揽月	给民造福敢入四海擒龙
送玉兔硕果丰收千里艳	迎巨龙宏图再展万年青
龙虎精神龙子龙孙功不灭	江山锦绣江南江北水长流
玉兔回蟾宫长空悬朗月	金龙上华表大地庆新春
改天换地狮啸八荒光八极	揽月摘星龙吟九派熠九州
喜值龙年经济腾飞增国力	乐迎盛世人民幸福焕春光
爆竹辞旧岁玉兔毫光生紫气	华灯照新春金龙捷足步青云
岁届龙年好跳龙门题雁塔	身弥虎劲敢凭虎胆占鳌头
海是龙故乡龙腾海宇龙光起	春为燕天地燕舞春风燕语新
虎将三千曾驭红鬃还伏虎	龙人十亿才跨赤兔又腾龙
虎跃龙腾万里长征风光无限	花香鸟语九州大地春色正浓
绣水描山神州大地春常在	藏龙卧虎盛世人家福永存
海是龙故乡龙腾海宇龙兴起	春为花世界花吐春光花盛开
爆竹飞花四海升平庆富庶	金龙献瑞九州欢乐唱丰年
龙腾岁首霞蔚云蒸万千气象	邑报梅开香飘色舞一派生机
爆竹迎春春光明媚人心畅	金龙还世世纪崭新国力雄
龙种自与常人殊，况逢龙岁	鹏鸟岂堪同日语，绝胜鹏搏
神州辞旧玉兔载誉返天宇	祖国迎新金龙携福降人间
物华天宝，欣闻禹域鸣雏凤	人杰地灵，喜看神州起卧龙
真豪杰无私无畏敢锯孽龙头上角	是英雄有胆有识能拔猛虎口中牙
岁属龙龙布雨雨顺风调呈稔岁	春迎燕燕衔花花团锦簇贺新春
巨龙引盛世狂欢爆竹声声辞旧岁	喜鹊羡故园起舞梅花朵朵报新春
兔去龙来四海喜金瓯共祝三通图一统	花明柳暗九州歌宝鼎同期两制乐千秋
玉兔走，金鸟飞，走走飞飞，飞向春光明媚处	雄狮欢，巨龙舞，欢欢舞舞，舞出华夏壮美图
龙展强邦志	蛇生富国情
龙留丰稔景	蛇舞吉祥图
金蛇含瑞草	紫燕报新春
蛇酿新年酒	花开盛世春
龙人承国运	蛇岁畅春风
龙舞山河壮	蛇盘世纪新
花放山河丽	蛇迎世纪春
银蛇盘玉兔	喜鹊闹红梅
山舞银蛇景	梅香瑞雪春
花开四季馥	蛇舞九州春
国期大治业	民庆小龙年
龙腾丰捻岁	蛇舞吉祥年
龙去神威在	蛇来春意浓
春归蛇起舞	福到鸟争鸣
花柳春风录	蛇年瑞气盈
蛇衔长寿草	燕舞吉祥家
金蛇狂舞日	紫燕报春时
捷报飞新宇	春潮促小龙
睛点龙飞去	珠还蛇舞来
春到田畴绿	蛇来淑景新
银蛇携福气	紫燕舞春风
龙去神威在	蛇来紫气生
龙吟山海壮	蛇舞国民欢
龙腾丰稔年	蛇舞吉庆岁
龙蛇交替舞	岁月又更新
大业中兴新世纪	宏图再展小龙年
风华正茂青春美	蛇岁呈欢世纪新
爆竹欣祝福	银蛇乐报春
小龙得志行风雨	彩蝶迎春戏牡丹
天地迎春弃旧貌	龙蛇接力展宏图
春呈丰稔景	酒贺小龙年
春来千野绿	蛇舞四时新
山欢水笑普天乐	龙去蛇来遍地春
人民有福歌新政	祖国长春舞小龙
云霞燕舞春光艳	灵草蛇衔寿气浓
大展宏图华夏伟	新开世纪小龙飞
山高水运人增志	蛇接龙年地满春
天浴朝阳蓬勃气	蛇含芝草吉祥年
灵蛇有意降春雨	绿叶无私缀牡丹
人怀壮志江山秀	蛇报新春世纪新
丰稔龙年留喜气	小康蛇岁溢春潮
小龙起舞神州地	祖国腾飞大治年
丰年盛景龙蛇舞	新岁春光彩蝶飞
风光无限蛇开泰	事业有为国展姿
寿草惊蛇开眼绿	春花惹蝶向阳红
天蓝水碧青蛇降	柳绿桃红紫燕飞
龙年国展腾飞志	蛇岁民抒奋发情
龙岁已开新世纪	蛇年又展好春光
风调雨顺年丰稔	龙去蛇来岁吉祥
龙抖雄姿归大海	蛇含瑞气报华年
出常山而雄岁月	腾大泽以壮神州
龙归碧海波涛舞	蛇到青山草木新
龙驾祥云门敛福	蛇衔瑞草户迎春
世纪神州添锦绣	蛇年伟业更辉煌
龙兴大业开新纪	蛇舞阳春奏凯歌
蛇献金珠龟献寿	鸟鸣玉宇鹿鸣春
灵蛇出洞吐春意	喜鹊登梅报福音
龙腾华夏春光丽	蛇蛰神州福气浓
蛇年喜庆丰收景	燕语欢歌幸福家
山蛇起舞云行雨	喜鹊争鸣雪点梅
银蛇舞处民心乐	喜鹊歌时韵味香
盛世龙腾留伟业	新年蛇舞起宏图
银花火树新春夜	丹凤金蛇大治年
四海龙腾佳日去	千山蛇蛰早春来
蛇吐宝珠辞旧岁	燕衔柳叶贺新春
金蛇披彩新春到	喜鹊登梅幸福来
天增岁月开新纪	春满乾坤舞小龙
龙戏高天鱼戏水	蛇游大泽燕游春
龙戏宝珠辞旧岁	蛇衔瑞草贺新春
大治山河铺锦绣	小龙日月更辉煌
去年龙蛰千重景	今日蛇迎四海春
当代英雄驱虎豹	崭新世纪舞龙蛇
蛇年迎春花开早	新年纳福喜事多
山舞银蛇呈异彩	原驰蜡象换新装
龙飞蛇舞升平岁	燕语莺歌盛世春
岁去年来新换旧	龙潜蛇舞景成春
喜鹊高歌传捷报	金蛇狂舞庆丰年
金蛇起舞春雷动	玉盏飞觞腊酒香
山舞银蛇春烂熳	路驰骏马景妖娆
世纪更新人不老	灵芝献寿蛇迎春
蛇年四季百花艳	燕影千家五谷丰
丰收喜讯龙刚报	长寿灵芝蛇又衔
岁辞龙尾春光好	山舞蛇姿景色娇
金蛇狂舞丰收岁	玉燕喜迎幸福春
当代精英抒壮志	蛇年禹甸起宏图
蛇行瑞气增春色	人展宏图壮国威
春帖相延新换旧	龙蛟交替瑞呈祥
金蛇狂舞迎春曲	丹凤朝阳纳吉图
金山水漫双蛇舞	绿野春归百鸟鸣
蛇献灵芝长寿草	民欢富裕小康年
新春喜饮金蛇酒	稔岁欣吟玉谷诗
大泽龙伏藏远志	莽原蛇蜕蕴生机
金蛇狂舞春添彩	紫燕翻飞柳泛青
新春喜鹊登枝唱	吉地银蛇降福来
蛇吐宝珠辞旧岁	龙含瑞气贺新春
龙歌甫吟家家致富	蛇琴一弄处处脱贫
祥龙兆祥蛇兆福	喜鹊报喜梅春早
龙回海底欣迎岁	蛇出山穴喜报喜
世纪图新金蛇曼舞	神州大治玉宇澄清
龙去犹存腾飞志	蛇来更有奋发心
八法龙蛇寻奥妙	万方翰墨出精微
龙留喜气喜盈门户	蛇闹春光春满山河
冯妇无憾重伏虎	颠客逞能赘画蛇
辞戊辰金龙述职	迎己已银蛇报春
龙腾碧海人间改岁	蛇舞青山大地皆春
山舞银蛇春烂漫	路驰骏马景妖娆
金龙含珠辞旧岁	银蛇吐宝贺新春
龙留喜气喜盈门户	蛇闹春光春满山川
山舞银蛇尘垢净	天嘘紫气彩云天
丰岁龙腾盈喜气	新年蛇跃涌春潮
玉龙留喜喜盈日月	金蛇闹春春满江山
刚过龙年走上康庄道	新逢蛇岁迎来改革潮
佳节舞龙蛇千家致富	东风荣草木万户迎春
灵蛇起舞鼓九州生气	彩凤腾欢庆四海升平
旭日扬辉崭新世纪呈春色	灵蛇起舞大好河山架彩虹
笑语声声金龙随冬去	欢歌阵阵玉蛇伴春来
龙归大海滚滚春潮逐浪起	蛇舞青云浓浓喜气盈门来
辰龙游碧宇霞蔚云蒸	已蛇掘黄金民富国强
龙舞雪花四野寒风随雪尽	蛇衔春色九天暖意逐春回
喜气闹新年千家报喜	春风暖蛇岁万户迎春
凤起蛟腾四海英才齐报国	龟动蟒出九州风物笑迎春
爆竹声声龙吟随腊去	凯歌阵阵蛇舞逐春来
凤舞龙飞锦绣河山添锦绣	蛇祥龟瑞富强中国更富强
天马行空日丽风和雨顺	灵蛇在世政通国泰民安
蛇岁纳千祥梅花开添春色	春光迎百福鹊口传报佳音
玉燕翻飞千秋大业千秋世	金蛇狂舞万里春风万里歌
山舞银蛇北国风光无限好	云飞紫燕南天春色更多娇
大地春回千里金涛香万户	小龙蛰起九州紫气贯长虹
凤起蛟腾四海人才齐建国	龟动蟒出满天风景正迎春
大地迎春柳伴梅香招蝶舞	高天降雨犁掀黄土应蛇行
金龙驻足留恋华夏春色美	银蛇昂首展望神州画图新
银蛇舞江城娇千帆竞发迎新岁	黄鹤飞楚地阔万马奔腾步小康
大地迎春柳伴梅香招蜂蝶	文坛焕彩笔掀墨浪舞龙蛇
盛世挹春风芝草灵蛇迎瑞气	丰年歌善政奇山秀水沐朝阳
银蛇舞江城美千帆竞发辞旧岁	黄鹤飞楚地阔万物峥嵘迎新春
巳岁不寻常，欣瞻祖国繁荣，处处管弦歌盛世	蛇年真雅化，喜见城乡活跃，家家诗酒贺新年
红旗映日	金马迎春
三春播喜气	万马荡雄风
马踏春锦绣	莺歌世风流
彩云追月	骏马迎春
人强马壮	春媚景明
万马奔腾日	九州幸福春
马腾风雪舞	春到杏花红
人欢马叫	春和景明
三春开盛纪	万马闯雄关
万马争飞跃	百花展笑颜
丰年飞瑞雪	骏马跃长征
百花齐放	万马奔腾
金蟒穿云去	紫骝踏雪来
春拂芬芳地	马奔锦绣程
腊鼓催青骏	春风策紫骝
乐驰千里马	更上一层楼
春色绿千里	马蹄香万家
闻鸡思奋发	跃马抖精神
蛇舞长城雪	马嘶北国风
迎春燕语巧	踏雪马蹄香
马跃康庄道	人迎幸福春
柳绿春江月	旗红骏马图
蹄花沾晓露	柳浪饰春风
扬鞭催骏马	把酒会春风
云霞出海曙	骏马跃关山
海阔凭鱼跃	路遥任马驰
马跃阳关道	春回杨柳枝
花开天下福	马跃人间春
立马昆仑小	腾龙世纪新
群星瞻北斗	万马啸东风
马啸关山月	莺歌杨柳春
神鞭催骏马	祖国壮金瓯
百花开锦绣	万马起云烟
霜蹄千里骏	风翩九霄鹏
鲲鹏飞玉宇	骐骥跃神州
天高鹏展翼	路远马扬蹄
花绽春光谱	马驰中国风
春新门载福	志远马扬蹄
燕莺新气象	龙马壮精神
立马千山矮	迎春万木荣
春来山水秀	马跃路途宽
骏马生双翼	鸿图壮九州
乐驰千里马	红花爱英雄
花香招鸟语	马跃起龙图
马驰春象里	人在画图中
春到红鬃马上	喜临绿柳门前
万马奔腾日	千门幸福花
凯歌辞旧岁	骏马跃新春
老骥志千里	新春花万重
风度竹流韵	马驰春作声
雪瑞年丰福满	人欢马叫春浓
人催千里马	国展五星旗
鹏举富强志	骏驰改革风
民驰千里马	国上一层楼
天马横空出世	腊梅傲雪迎春
一堂开淑景	万马度新春
高风驰骏马	大道有晴天
有缘识骏马	无私荐良才
春到江南塞北	马腾正气清风
骏马秋风蓟北	杏花春雨江南
一路马蹄花引蝶	万家春色柳闻莺
人欢马叫丰收岁	狮舞龙腾改革潮
雪片纷纷凝瑞	马蹄得得报春
八骏风驰千里近	一年花发十分红
人得春风牛得草	国扬威力马扬蹄
尚存金蛇灵气	重振龙马精神
十里早莺鸣暖树	一群骏马跃雄关
千树流莺歌丽日	八方跃马上征途
一夜春风来小院	千匹骏马闯雄关
九天日暖张鹏翼	四野春新逐马蹄
万缕彩霞迎旭日	千匹骏马带朝烟
十分春色辉天地	万马蹄花入画图
马驰大路春如锦	鹰击长空气若虹
天马行空迎盛纪	黄莺戏柳报新春
大鹏欢喜天空阔	骏马何愁道路长
马蹄声碎开新路	春酒味浓贺大年
无边春色百花艳	有庆年头万马驰
小龙游罢清平世	骏马腾欢大有年
千里江山春气象	一年锦绣马风光
风尘一路马蹄碎	爆竹千家春意浓
马步青云迎旭日	羊腾绿野展雄风
千帆竞渡千重浪	万马奔腾万里春
文明盛世飞春色	锦绣前程亮马蹄
马蹄得意奔新路	鹊语遂心报好音
大路长征驰骏马	中华伟业展雄才
白马壮心奔大道	青春浩气献中华
千树春花争早放	万骑骏马着先鞭
小龙大展鹏飞志	骏马方乘改革风
冬去蛇留诗意美	春来马跃画图新
万里清风舒画卷	一鞭神骏奋前程
马奔大道风生响	春到农家雪吐香
色借梅花香借雪	壮观骏马美观春
万马奔腾五彩路	百花齐放四时春
马不停蹄传捷报	人行阔步闯雄关
天高碧宇随鹏举	路远轻风任马驰
大鹏展翅青云路	骏马奔驰浩荡春
门前春色迎人笑	路上蹄花映眼新
化日舒长莺语巧	春风得意马蹄矫
飞驰骏马鞭高举	欢庆新年酒满斛
世纪春风吹绿野	中华神马啸新程
风光秀丽随春展	道路逶迤任马驰
东方古国红旗舞	大路长征骏马驰
张灯结彩迎春节	跃马扬鞭步小康
文章须纳风云气	翰墨应催骏马图
万里征途千里马	十年树木百年人
向阳花木三春秀	得意马蹄一路风
庆盛世雄狮起舞	展宏图快马加鞭
古柳荫中来走马	好花深处有鸣禽
有志宝驹奔大道	无边春色驻神州
红霞瑰丽铺云路	骏马奔腾荡柳烟
百花齐放春光好	万马奔腾国步雄
江涛气势风雷动	龙马精神世纪兴
迎春策马声威壮	破浪扬帆气势雄
改革新潮催骏马	振兴大业起鸿图
伟业千秋人奋志	征途万里马嘶风
花木向阳春不老	骅骝开道景无边
水如碧玉山如黛	人奋雄心马奋蹄
扬鞭策马开新纪	立志兴邦展壮猷
英雄骏马奔千里	浩荡春风暖万家
化雨携来龙露贵	踏花归去马蹄香
金戈铁马奔大道	碧血丹心献中华
春风得意人得志	骏马扬蹄国扬威
伏枥犹存千里志	添翼更上九重天
春风笑逐福音至	天马喜随捷报飞
春阳送暖芳菲地	骏马奔驰锦绣程
老骥常存千里志	夕阳惯照万重山
春风万里辞蛇岁	笑语千家入马年
春返神州舒画卷	马腾盛世入诗篇
金蛇狂舞九州景	骏马欢腾四海春
春花吐艳香千里	快马加鞭跃九州
奔腾骏马驰大道	浩荡春风遍神州
伯乐明眸识好马	良才妙手展宏图
英才竞献兴邦策	骏马齐奔强国途
春天点点芭蕉雨	马步声声杨柳风
宏图锦绣众人绘	大道逶迤万马驰
昂首扬鬃腾浩气	奋蹄踏雪展春风
春风化雨芭蕉翠	骏马登程杨柳青
英雄气概凌天宇	骏马雄风荡柳烟
春风碧水双鸥静	旭日青山万马嘶
春归禹甸风光美	马纵山河气势雄
奔彼岸千帆竞渡	越坦途万马扬鞭
政策英明民放胆	神驹腾飞国扬威
春江花月宜人景	龙马海风强国图
花柳新春莺燕舞	风云盛世骏骇驰
绿野苍茫驰骏马	蓝天浩瀚搏雄鹰
春情寄语千条柳	骏马加鞭万里程
青春壮丽辉天地	骐骥奔腾向未来
映日红霞浮白马	宜人春色到农家
秣马厉兵精武略	安邦治国识文韬
秋风古道题诗瘦	落日平原似马豪
高天雪舞银蛇去	大地春归骏马来
跃马扬鞭抒壮志	耕云播雨夺丰收
神驹轻踏春前草	小燕喜穿柳上风
蛇辞禹甸三春丽	马跃神州百业兴
庆佳节九州同乐	贺新春万马奔腾
福到门庭梅吐艳	马驰道路柳生烟
骏马奋蹄千里路	大鹏舒翼九重天
勒马开怀颂改革	迎春祝酒庆丰年
南岭梅香迎岁至	东郊草浅试蹄轻
跃马日行九万里	腾龙历展二千年
鸿雁翔云迎旭日	青骝夺路起桃烟
绿水青山迎宝马	红梅白雪送灵蛇
得意春风催骏马	及时惠雨润鲜花
莺歌燕舞芳菲节	马叫人欢婀娜春
人欢马叫升平世	燕语莺歌锦绣春
挺身愿作长征马	俯首甘为孺子牛
雄关似铁千骑越	捷报如云万里飘
旗展五星四海笑	马奔万里九州春
美景前程欣骥足	高天浩宇快鹏心
蓝图全靠能人绘	骏马还凭伯乐挑
银蛇带去峥嵘岁	骏马迎来锦绣春
莺歌杨柳枝枝秀	马跃前程步步高
大道扬鞭驰骏马	高天阔地展雄才
新骏扬鞭奔大道	亲朋酌酒贺丰年
梅花欢喜漫天雪	骏马奔驰一路春
豪情振笔歌新岁	骏马加鞭奔坦途
莺歌柳浪千家笑	马踏春风一路花
雄狮竞舞中华志	骏马奔腾民族风
人强马壮康乐日	囤满仓流富裕年
腾海蛟龙频击浪	识途老马自扬蹄
新春贻留去样草	骏马图挂墨韵斋
雄心驯服腾云马	壮志敢擒出海龙
芳草有情皆碍马	好云无处不描天
新岁新春新景象	好人好马好前程
车水马龙农家乐	花香鸟语大地春
辞年喜饮三蛇酒	贺岁争描八骏图
蹄花千里沾晨露	柳浪万重叠夕阳
满园春色偕金马	大地歌声焕彩霞
紫气东来春得意	青云直上马扬蹄
戎马生涯留壮史	逐龙健步度晚年
政策归心人振奋	春风得意马腾飞
一轮春月参花影	四化征途骤马蹄
骏马奔腾春色丽	艳阳照耀岁华新
一夜报春百花齐放	三阳开道万马奔腾
化雨携来龙露贵	踏花归去马蹄香
魏武挥鞭吟老骥	悲鸿泼墨画神驹
马蹄踏碎一穷二白	燕子衔来万紫千红
大道征程驰骏马	高天阔海展雄才
马叫人欢奔旭日	风驰电掣奋征程
快马加鞭振兴祖国	闻鸡起舞建设家园
才如天马行空惯	笔似飞蛇戏水轻
同心同德宏图再展	群策群力快马加鞭
有道疾风识劲草	常言骏马恋征途
喜盈门天乐人亦乐	春及第心欢马更欢
金蛇喜舞九州富	骏马欢腾四海春
跃马迎春春风扑面	抬头见喜喜气盈门
文章各领江山气	翰墨轻拈骏马图
万马千军创大业	五湖四海涌春潮
大海方平千帆竞发	征途正远万马奔腾
立马昆仑山岳伟	扬帆大海浪涛雄
马跃人欢九州欢洽	鱼肥秧壮四海春浓
好雨知时百花齐放	春风得意万马奔腾
春风得意马驰千里	旭日扬辉光照万家
锦绣山河春和世泰	峰嵘岁月马叫人欢
行而不合若骥千里	纳无所穷如海百川
明媚春光百花竞放	昌隆国运万马奔腾
骏马嘶风九州辞旧	杏花沐雨四海迎新
新貌新风喜迎新世纪	好鞍好马驰骋好前程
马壮牛肥山村添喜气	地灵人杰门户沐春风
五谷丰登银蛇载誉去	百花争艳金马踏春来
鸟语花香九州春色好	人欢马叫四季画图新
百花争艳祖国春光好	万马奔腾改革事业兴
快马舞东风春盈四海	梅花香大地喜满九州
赤帜舞东风江山如画	青骝奔大路祖国长春
鱼跃鸢飞光景随时好	人欢马叫春潮逐浪高
奇迹不奇英雄能创造	远征非远良马自奋蹄
旧岁蛰蛇蛇舞青山山愈秀	新春跃马马奔大路路更宽
万马奔腾为江山添锦绣	宏图再展与日月竞光辉
玉宇澄清花香鸟语升平世	金瓯永固马叫人欢幸福春
宏图大展成就行行伟业	骏马奔腾飞越道道雄关
丽日蓝天万树春花争早放	阳关大道千匹骏马着先鞭
步新潮须骑骏马驰千里	兴伟业应唤春风惠万家
花红柳绿河山壮丽门庭秀	民富国强龙马奔腾世纪新
爆竹迎春春丽五湖四海	红梅报喜喜催万马千军
快马加鞭协力同心跟党走	葵花吐蕊栉风沐雨向阳开
大地回春锦绣河山添异彩	征途跃马英雄儿女着先鞭
继往开来世纪春光无限好	承前启后神州骏马有奔头
凤舞龙腾腾龙兴国创新业	人欢马跃跃马扬鞭赴锦程
小龙辞岁，好凭妙手书鹏赋	骏马迎春，当显雄才唱大风
策马争春马跃马年加马力	驾龙追日龙腾龙国振龙威
展智施能，雄心共创千秋业	扬鞭跃马，矢志同奔万里程
展宏图九州英才扬鞭跃马	创伟业四海豪杰破浪飞舟
雨润三春，披红戴绿千山舞	旗飘四化，跃马扬鞭万众忙
跃马加鞭四化征途奔万马	扬帆破浪一江春水涌千帆
爆竹一声，喜送巳蛇留庶绩	华灯万盏，欣迎午马展嘉猷
小龙舞九州龙伴腊归留胜迹	大骥驰千里骥随春到展宏图
蛇舞取胜，除暴安良政局稳	马到成功，兴益除弊国力强
万里蓝天莺歌燕舞春光无限	千村碧野马叫人欢淑景连绵
银蛇归去，盛赞人间春色美	金马奔来，争夸祖国气象新
振兴伟大中华道路驰骋千里马	迎接崭新世纪人民团结一条心
看旧岁银蛇起舞，群山增秀色	喜今朝骏马奔驰，九野尽春晖
骏马早迎春一代英豪图改革	黄莺初唱晓千声乐曲唱丰收
农村兴旺同庆丰收谷似金山煤似海	城市繁荣共迎新岁车如流水马如龙
花香丰稳岁	燕舞吉祥图
鸣莺传燕信	策马赴羊年
羊酒敬新春	骊歌辞旧岁
金羊启泰	彩凤鸣春
春草连天绿	羊群动地吹
腊鼓催神骏	春风送吉羊
未时骄阳艳	羊岁淑景新
马驰万里	羊恋千山
骏马归山野	灵羊爱草原
马载祥云去	羊携惠雨来
羊岁骄阳盛	未时淑景新
羊肥马壮	国富民丰
马去雄风在	羊来福气生
马蹄腾瑞雪	羊角触红梅
马去雄风在	羊归祯岁来
羊迎大吉	岁纳永康
马蹄留胜迹	羊角搏青云
五羊开玉局	万马闯雄关
马尾扫飞雪	羊头触艳梅
三羊开泰日	万事亨通年
羊毫抒壮志	燕梭织春光
春新羊得草	世盛马加鞭
笙歌辞旧岁	羊酒庆新春
三羊生瑞气	百鸟唤春光
春来羊起舞	雪化马归山
骏马奔千里	吉羊进万家
风吹飞柳絮	墨舞醉羊毫
五羊争献瑞	万马喜留春
金马辞旧岁	银羊贺新春
马辟长安道	羊开大吉春
马岁家家如意	羊年事事吉祥
丁年方鼎盛	未雨欲绸缪
马拓康庄道	羊铺锦绣云
天涯芳草绿	华夏玉羊欢
骏马四蹄击鼓	羚羊双角开春
马嘶飞雪里	羊舞画图中
马跃庆丰年	羊鸣歌盛世
马蹄留胜迹	羊毫谱新歌
马啸英雄浩气	羊鸣世纪春光
骏马春常在	吉羊福又添
对韵俨龙马	联书大吉羊
立志当怀虎胆	求知莫畏羊肠
水秀山明草茂	羊肥马壮春荣
红梅赠马岁	彩烛耀羊年
马革酬壮志	羊碑纪丰功
喜鹊登枝祝福	灵羊及第呈祥
乌金黄土故地	白羊绿野新郊
马年腾大步	羊岁展宏图
八骏荣归除夕夜	三春新谱放羊歌
人怀远志驰良马	世易新春唤白羊
马去抬头见喜	羊来举步生风
万象更新新世纪	五羊献瑞瑞门庭
马甲雄骑赢胜利	羊羹美酒庆丰收
八骏奔腾创伟业	五羊跳跃展新图
万象已随新律转	五羊争跃好春来
一片白云羊变幻	千条翠柳燕翻飞
马驰大道征途远	羊上奇峰景色娇
五羊衔穗年丰捻	双燕迎春岁吉祥
世上尘埃随马尽	人间春色逐羊来
马首是瞻跟党走	羊毫在握为民挥
长空载誉夸天马	大地回春颂吉羊
白羊越涧探春景	紫燕绕梁报福音
马尾劲松承雨露	羊毫妙笔点春光
玉宇澄清观燕舞	草原茂盛喜羊欢
五羊献瑞人增寿	百鸟鸣春喜盈门
玉羊启泰迎春至	金马奋蹄载誉归
世纪更新花吐艳	春风送暖瑞呈祥
羊群拥起千堆玉	稻浪浮来万亩金
不舍风驰追马迹	行看岁稔话羊年
马首是瞻新世纪	羊毫尽绘好春光
吉羊得草延春色	紫燕衔泥落好家
世纪春风萌绿草	山乡柳笛放群羊
马尾松青凝瑞雪	羊毫笔墨舞春风
驯马腾飞千里路	牧羊更上一重峰
马驮硕果归山去	羊踏青坪报喜来
灵羊捷足登新境	骏马奋蹄向未来
马驰碧野凯歌壮	羊跃青山景色新
灵羊下界盈门喜	乳燕衔泥满院春
五羊结彩迎新纪	六畜兴旺报好年
金穗飘香香四季	玉羊报喜喜千家
羊群簇拥千堆雪	燕子翻飞一世春
玉树葱茏皆出色	金瓯稳固不亡羊
马蹄踊跃驰千里	羊角扶摇上九霄
喜得马年成骏业	笑看羊岁展鸿图
金马扬蹄抒远志	玉羊接力展鸿图
春露秋霜连广宇	羊肠鸟道变通途
岁焕新风燕剪柳	春来大地羊铺云
画展春城描特色	诗题羊石纪新春
得意春风扬马首	宜人景色赖羊毫
金凤呈祥人得意	玉羊衔瑞事称心
神骏回眸丰稔景	灵羊尧首吉祥图
骏业辉煌归历史	羊毫遒劲谱新篇
宝马腾飞迎福至	灵羊起舞报春来
得意春风仍疾马	连天碧草又宜羊
催马唤羊逢盛世	叱云沐雨览新春
惜别垂杨难系马	喜瞻叱石尽成羊
骑马牧羊歌盛世	顶凌踏雪报新春
鲲鹏展翅扶羊角	莺燕欢歌送马蹄
北岭春深宜牧马	南郊草浅待牵羊
万木争荣浮春色	五羊献瑞有福音
狐裘卅年名相德	羔革五缄大夫风
得意春风催快马	解人新岁献灵羊
羊饮春水山村碧	人领风骚当代雄
赠鹿果然圆旧梦	牧羊缘事动衰思
羚羊挂角挑春色	喜鹊登枝报福音
羊肥马壮人人喜	酒绿灯红户户欢
龙凤腾飞迎一统	马羊接力赛三春
骏马腾飞成壮举	灵羊起步赴新程
羊膏美酒同辞岁	白发红颜共庆春
庚午祝捷神马去	辛未报喜宝羊来
草肥水甜牛羊壮	人杰地灵五谷香
乙近杏花袍曳紫	未匀柳色绶拖黄
春草茸茸催马壮	碧溪潺潺助羊肥
楼头有伴应归鹤	原上无人见牧羊
尝辛椒酒争迎岁	开未梅花早报春
驰骋春风追丽日	扶摇羊角步青云
羊年喜千家祝福	国运昌万物生春
报本恩羊思跪乳	忠心职鸡惯司晨
马驰原野繁花茂	羊跃神州事业兴
五羊城中春光好	九州域内人面新
一派生机阳春映日	满天焕彩浩气腾云
送马年春花融白雪	迎羊岁喜鹊闹红梅
马年已绘丰收景	羊岁继吟致富诗
北斗光明春台起凤	南溟壮阔羊角搏鹏
碧草白羊三春图画	金戈铁马万里征途
春满神州舒画卷	羊临华夏入诗篇
时雨春风五羊献穗	尧天舜日百凤朝阳
羊接马岁草原兴旺	野连绿茵牧业丰隆
九州百族辞马岁	两岸三通接羊年
送马年春花融白雪	迎羊岁喜鹊闹红梅
好鸟鸣春歌盛世	吉羊启运乐升平
喜鹊迎春红梅香瑞雪	吉羊贺岁金穗报丰年
万马扬蹄踏凯歌而去	群羊翘首唤春信即来
绿草如茵，羊盈瑞气	红桃似火，猴沐春风
岁序更新马年留胜绩	春风初度羊志展鸿猷
红杏丛中朝见牛羊出圈	绿柳郊外夕闻鸟雀归林
艳阳高照江山添锦绣	壮志常存祖国更富强
羊兆祥和熙攘万方歌盛世	马无驾钝奔腾千里赴前程
喜洋洋绿水青山春永驻	美泰泰丰衣足食福无边
羊笔如椽描山绘水书春意	马蹄腾雪步韵留香报福音
岁届吉羊燕舞莺歌齐祝福	年逢盛世桃红柳绿尽芳菲
羊酒微醺酡颜人共桃符艳	春风乍拂捷报声随爆竹传
万马消尘蹄声响彻三千界	五羊衔瑞春意浓于二月花
老马识途破雾导航奔胜境	吉羊接力承先启后展宏图
三羊开泰来处处三春美景	五福骄臻至家家五谷丰登
国富民殷羊毫挥颂千秋业	年丰人寿燕剪裁成万户春
马去羊来华夏腾飞添马力	龙吟虎啸天公抖擞降龙才
春暖人心世界三千同雀跃	风搏羊角云程九万共鹏飞
马首是瞻美酒千盅迎曙色	羊毫初试豪情万斛写春光
前路辉煌笑看骏马追风去	雄雷霹雳喜见商羊带雨来
天马班师捷报频传惊宇宙	仙羊降世宏图再展耀神州
浩气常存频加马力奔新路	雄风不减再握羊毫绘壮图
月异日新不少羊肠成大道	春和景泰好多蜗舍变高楼
骏马荣归一路梅花频送笑	吉羊喜欢驾九州绿草铺春
燕啄春泥万户厅堂增瑞气	羊开岁序千村庭院起祥光
马步牵长风长随远景江山好	羊毫书大举大展鸿图世纪新
骏马辞年不懈奔腾千里志	吉羊献岁同迎欢乐万家春
送马庆丰功又是一年芳草绿	牵羊迎盛世依然十里杏花红
瑞雪绽红梅君正啸天傲地	芳春织绿草我来放马牧羊
凯歌阵阵千军万马早过玉门关	春风习习带头羊又登泰山绝顶
门对青山羊兔群群嬉碧毯	窗外绿水鸭鹅队队戏青波
玉宇迎春至	金猴献寿来
羊舞丰收岁	猴呈福寿春
世纪春光好	猴年气象新
申时听瑞雪	猴岁望丰年
羊踏雪霜地	猴攀桃李枝
迎春猴降世	报国志凌云
猴桃献寿	鸟语迎春
攀山人长志	观海猴忘忧
金猴扶正气	玉宇荡清风
羊毫描特色	猴棒舞雄风
羊跃康庄道	猴腾锦绣云
羊衔金穗云	猴捧寿桃来
金猴欣献寿	玉燕喜迎春
金猴征腐恶	玉宇蔚清明
燕勤家业富	猴正世风清
羊蹄踏锦绣	猴棒鼓雄风
金猴当大任	铁臂展宏图
春光辉特色	玉宇赖金猴
申年梅献瑞	猴岁雪兆年
宏图开玉宇	盛世显金猴
金猴临盛世	瑞雪兆丰年
神猴变万象	盛世鉴千年
羊辞玉乾坤	猴奔花果山
金猴方启岁	俊鸟又催春
神猴翻筋斗	赤鲤跃龙门
金猴扬正气	禹甸展鸿酞
戊春闻燕语	申命演牺经
羊辞清淑景	猴报吉祥年
新春呈万象	大圣奋千钧
金猴驱虎豹	经济舞神龙
大圣光临扬正气	小康喜过蔚新春
旗展五星画	猴翻万里云
美猴腾瑞气	金鲤戏春波
古木鸣寒鸟	空山啼夜猿
鸟语喧花果	猴啼挂水帘
金猴捧硕果	华夏起宏图
群猴齐祝福	举国共迎春
羊舞丰收岁	猴吟锦绣春
金猴开玉宇	紫燕舞新春
火眼金睛开玉宇	红梅绿柳报新春
羊跃年终传捷去	猴观岁首报春来
羊隐神州千户富	猴临大地万家春
天增岁月人增寿	猴献蟠桃鹿献芝
羊逐金花驰碧野	猴攀绿树步青云
禾生嘉穗家家乐	猴献蟠桃处处春
羊留伟绩兆新运	猴展神威乐小康
羊裹银装知玉洁	猴生火眼识真金
羊角扶摇辞旧岁	猴王喜闹庆新春
羊捋银须夸改革	猴持金棒写春秋
羊年得福全家福	猴岁迎春遍地春
羊毫点缀千秋业	猴棒辟开万里程
玉宇清明春色好	金猴奋起国光新
子时羊伴烟花去	春晓猴乘爆竹来
羊毫扎笔描春色	猴子腾云振国威
玉燕迎春春永驻	金猴降福福常存
金猴奋起迎新纪	喜鹊争鸣报福音
丰年瑞雪宴华夏	猴岁良宵乐纪元
羊伴吉祥留喜庆	猴持如意保平安
金猴献寿人民福	喜鹊登梅小院香
回首羊年呈喜庆	举眸猴岁报平安
羊弄笛音奏妙曲	猴攀桃树祝新年
金猴挥棒扶正气	绿野走犁绣春光
金猴携福人间驻	绿柳迎春大地新
羊聚祥云天降玉	猴腾紫气地生金
羊聚成云天降玉	猴来踏露地生金
民颂金猴澄玉宇	岁迎紫气送灵羊
阳春初览小康景	新岁益坚大圣心
猴来佳果满山醉	春至繁花遍地香
羊挟清风辞盛世	猴迎旭日耀新春
辞岁羊毫书捷报	迎春猴棒舞乾坤
金猴奋起神州乐	紫燕翻飞大地春
羊衔玉穗登勤第	猴捧仙桃入福门
喜鹊鸣春春日丽	金猴献岁岁华新
猴年万事皆如意	春苑百花尽吐香
金猴得意迎春早	赤子倾心建国忙
猴山花果红如锦	瑞地禾苗绿似茵
春满神州多喜气	猴澄玉宇荡清风
金猴奋起群山翠	祖国腾飞四海春
猴献蟠桃祝万福	春临大地发千祥
窗外嫩枝应候绿	楹前春帖向阳红
雪消门外千山绿	猴到人间万户春
紫燕翩翩飞锦地	金猴跃跃步春晖
紫燕翻飞千里景	金猴攀跃万年枝
羊毫已写辉煌史	猴岁又描锦绣图
瑞雪纷飞迎盛世	金猴欢跃报丰年
满园春色探墙外	两岸猿声报喜来
龙国诗国文明古国	猴年吉年富裕新年
桃林片片千山秀	猴岁家家万象新
大地春回山河壮丽	金猴奋起玉宇澄清
紫燕展翅腾柳浪	金猴攀援上春山
碧野千里铺锦绣	金猴一群闹春园
梅柳渡江九州春暖	羊猴换岁四海花香
猴喜满园桃李艳	岁迁遍地春光明
歌舞翩跹欣大治	桃符耀灿贺猴年
猴捧仙桃国安人寿	羊衔嘉穗物阜年丰
未羊申猴兴国瑞	莺歌燕舞喜春光
玉羊毫多添文采	金猴棒大鼓雄风
玉燕嬉春九州焕彩	金猴献岁万国呈祥
金猴献瑞财源广	紫燕迎春生意隆
翠竹迎春金猴献宝	红梅傲雪喜鹊登枝
羊羯回头添如意	猴王振臂保平安
银树呈祥花果硕	金猴献瑞国民殷
廉政兴春羊碑映日	贤才治国猴棒擎天
猴偕丽日庆盛世	燕舞春风迎新年
人寿年丰神猴献果	山明水秀雏燕迎春
紫气氤氲邦歌乐土	春风浩荡岁喜金猴
金猴玉兔弄春色	紫燕黄莺弹妙音
羊驾瑞云去留一天瑞气	猴挥金棒来闪万道金光
紧握羊毫留青史	奋挥猴棒辟征程
羊絮飘蓝天装点辉煌世纪	猴音绕绿水畅流幸福人家
羊去猴来九州留瑞气	龙骧虎步四海涌春潮
羊致祥和金瓯永固千年福	猴开锦绣玉宇澄清万里埃
金猴献礼，家家顺利	喜鹊闹春，事事吉祥
金猴舞时阴云扫尽金瓯固	玉音飘处薄雾吹开玉宇清
羊年六畜兴旺五谷丰登	猴年九州欢歌四化辉煌
喜鹊登枝为大地回春祝福	金猴舞棒给中华崛起扬威
瑞雪迎春笑看九州桃李艳	金猴献寿欣闻四海笙萧喧
鹏翼扶摇搏击方知云浩瀚	猴身灵动攀登何惧路崎岖
风云变幻金猴挥棒澄寰宇	世纪更新赤帜扬辉耀古今
黄龙竞舞为大地回春祝福	金猴挥棒给神州崛起壮威
玉宇澄清兴国强邦图大业	金猴奋起倡廉反腐振雄风
镰运锤挥，万古江山开盛世	龙骧虎奋，九州儿女刨殊荣
猴年赞金猴，棒奋千钧除腐败	世人歌盛世，家兴万富民康宁
放眼望神州金猴辟开万千气象	开门闻喜讯盛世迎来又一春秋
鸡鸣村觉晓	鱼戏水知春
玉宇迎春丽	雄鸡昂首歌
金鸡鸣富足	彩凤语祥和
闻鸡起舞	跃马争春
鸡声堪唱晓	花月可留春
鸡鸣一日首	梅绽百花前
闻鸡人起舞	放鸽世和平
山鸡舞镜	天马行空
玉宇清风夜	金鸡淑景春
鸡鸣天下白	梅放雪中香
鸡唱千门晓	莺歌万里春
鸡鸣晓旦	燕舞阳春
迎春鸡起舞	创业国腾飞
鸡声催晓读	鸟语唤春耕
雄鸡歌盛世	爆竹奏凯歌
鹊报春喜	鸡传佳音
鸡叫霜晨月	人迎世纪春
鸡唱康平世	鹿鸣福寿春
金鸡石上立	紫燕柳间飞
旭日光天地	金鸡报吉祥
鸡鸣春富贵	鹊报岁平安
金鸡歌晓旦	乳燕舞新春
金鸡鸣盛世	特色壮神州
鸡鸣大地醒	鹊报满园春
雪舞普天瑞	鸡鸣遍地春
金鸡鸣盛世	紫燕舞新春
鸡鸣窗外月	人笑福中春
鸡鸣万户晓	燕舞四时春
雄鸡瞻玉宇	赤帜舞金瓯
鸡唱唤春晓	人歌动地诗
鸡歌能醒梦	花月可留春
雄鸡歌曙色	妙手绣春光
鸡鸣万户晓	鹤舞一年春
雪融金谷满	鸡报玉堂春
春暖金鸡唱	才高五尺量
鸡唱中兴世	鹿鸣大有年
雪白寒梅艳	鸡歌春谷晴
鸡鸣茅店月	人迹板桥霜
鸡声天下曙	春意海南潮
金鸡刚唱晓	喜鹊又登梅
九州曙色金鸡唤	四海春风紫燕掀
千重柳浪惊莺梦	三遍鸡声破曙光
万里春光五彩画	一声鸡韵九州春
金鸡一唱千门晓	绿柳千条四海春
五更鸡声声唱晓	千里马步步登高
金鸡啼出千门喜	春帖换来万象新
千里鸳歌春泛绿	九州鸡唱日初红
金鸡晓唱千家喜	白鹭齐飞万户春
一世清明开盛纪	百花烂漫缀鸡年
五更夜静金鸡唱	八斗才高玉尺量
有凤来仪昭大治	闻鸡起舞着先鞭
四季花香蝴蝶舞	三春喜讯鹊鸡鸣
户外鸡声催晓日	屏前人影醉春风
白雪吉兆丰稔岁	金鸡喜报太平年
千家新燕歌春韵	元日雄鸡唱福音
引来曙色随鸡舞	唤起春风催马驰
兆丰消息听瑞雪	报喜佳音看金鸡
广厦闻鸡同起舞	长征跃马共腾飞
白鹤青松长寿景	金鸡红日艳阳春
创业闻鸡晨起舞	兴邦策马早腾飞
日新月异金鸡唱	鸟语花香大地春
好景丰年飘瑞雪	佳音喜讯望雄鸡
金鸡报晓青山秀	紫燕凌空旭日升
一代风流兴大业	满天曙色唱金鸡
画意正浓鸡起舞	诗情未尽蝶翻飞
金鸡啼处腾红日	春水流时淌福音
日新月异群鸡舞	雨顺风调五谷丰
鸡鸣万壑长天锦	日耀千山大地春
春信千家传紫燕	福音万户报金鸡
引颈高歌鸡起舞	举旗奋进国腾飞
鸡鸣燕舞千门福	世盛人欢四海春
闻鸡踏碎霜晨月	跃鹊催开一剪梅
白鹤飞来万户寿	金鸡唤醒五湖春
枝头喜鹊言春早	院里金鸡报岁新
庭院鸡鹅谈好事	枝头燕雀话丰年
早春喜讯金鸡报	四季花香彩蝶迷
闻鸡起舞从今日	跃马扬鞭正此时
唱晓金鸡歌盛世	长征骏马着先鞭
迎春雅兴闻鸡起	祝福豪情伴鹊生
庭前落絮早春柳	梦里新歌晓日鸡
鸢观故国千山秀	鸡唱新春万里娇
鱼游春水纳余庆	鸡唱曙光报吉祥
彩凤鸣春春不老	雄鸡报晓晓生晖
鸡唱五更春早至	凤鸣九域国中兴
金鸡高唱山河丽	布谷争鸣稻米香
金鸡喔喔传春汛	喜鹊喳喳报福音
鸡鸣拂晓河山秀	春满神州气象新
金鸡献岁人民福	丹凤朝阳世纪春
鸡登石上鸣日月	鹤立松间阅春秋
鸡观盛世风云净	鹊闹红梅庭院香
金鸡高唱丰收曲	紫燕喜吟幸福歌
鸡鸣五谷丰登景	燕舞千家幸福年
春晨旭日雄鸡唱	杨柳清风乳燕飞
金鸡昂首歌春晓	骏马奋蹄跃锦程
雄鸡唱晓新春到	喜鹊登枝幸福来
庭前春晓雄鸡舞	世上风清燕子飞
猴入水帘清玉宇	鸡鸣曙色亮神州
堤柳欲眠鸡唤醒	春花初绽蝶闻香
喜听鸡唱迎春曲	又见雀衔致富图
跃马腾飞兴骏业	闻鸡起舞绘鸿图
喜报人间逢盛世	春盈大地舞金鸡
梅花吐艳新春丽	鸡韵成歌盛世长
晨光初露雄鸡唱	红杏出墙彩蝶飞
猴去江山添秀色	鸡来日月发春辉
雄鸡高唱催春早	彩凤长鸣颂世昌
紫燕迎春穿绿柳	金鸡交岁舞丹阳
猴随腊去欣除旧	鸡唤春来喜布新
喜鹊登梅门有喜	金鸡报晓地生金
猴舞中华山水美	鸡鸣大地晓光新
盛世鸡鸣犹悦耳	新春燕舞自开心
献岁鸡声融捷报	迎春爆竹会佳音
紫燕旋飞寻旧宇	金鸡高唱贺新年
腊梅一开报春信	雄鸡三唱兴中华
梅迎春意添新色	鸡沐风光报福音
碧水清波观鸭泳	竹篱农舍有鸡啼
日新月异金鸡唱	鸟语花香溪水流
客梦好凭流水浣	鸡鸣或有故人来
爆竹千声歌盛世	金鸡三遍唱丰年
雄鸡一唱鸣春晓	喜鹊双飞报佳音
夜静月明观玉桂	晨清日暖卧金鸡
新春消息鸡先报	小院梅香鹊早知
紫燕旋飞寻旧岸	金鸡高唱贺新年
守夜忠职劳玉犬	司晨任怨有金鸡
瑞雪纷飞年大有	金鸡起舞岁平安
金鸡啼抬头见喜	春风吹举步生辉
鸡韵入帘时正午	花香动扉日方晨
碧野千重铺锦绣	金鸡一曲唱丰收
金鸡啼开千门喜	东风吹入万户春
碧水清波观鱼跃	竹篱农舍听鸡啼
喜鹊登枝迎新岁	金鸡起舞报福音
玉管千声歌玉镜	金猴一抖唱金鸡
金鸡报晓歌大治	丹凤朝阳赞中兴
瑞气盈门勤致富	金鸡报晓广生财
金鸡高唱千门晓	红杏巧悬万户春
闻鸡起舞迎元旦	击壤而歌颂小康
舞剑闻鸡成大器	擎旗纵马请长缨
癸戴草头朝赤日	酉添春水上朱颜
鸡报小康随日出	年迎大有伴春来
献岁金鸡鸣喜庆	迎春紫燕舞祥和
雄鸡喜报春光好	健笔勤书正气多
鸡鸣晓日江山丽	犬吠神州岁月新
金鸡喜唱催春早	绿柳轻摇舞絮妍
猴奋已教千户乐	鸡鸣又报万家春
鸡鸣喜报丰收果	犬吠欣迎富贵宾
金猴留恋丰收年	彩凤欢啼盛世春
跃马扬鞭芳草地	闻鸡起舞杏花天
布谷鸣春年丰物阜	金鸡报晓国泰民安
鸡描竹叶三中颂	犬绘梅花五福临
鸟报晴和花报喜	鸡生元宝地生财
玉宇澄清花香鸟语	金鸡报晓人寿年丰
金鸡唤出扶桑日	锦犬迎来大地春
雄鸡唱罢九州乐	金犬吠来四海安
金鸡醒梦春光正好	骏马登程旭日方升
鸡报新春春光明媚	猴辞旧岁岁月峥嵘
鹰击长空兴邦有志	鸡鸣大地治国倾心
大地春回金鸡报晓	中天日丽玉宇生光
踏雪迎年寻梅岭表	闻鸡报晓试马春郊
司晨报晓鸡有勤劳美德	激浊扬清猴留战斗精神
三春景好闻鸡先起舞	两岸情深盼燕早归来
远景初描猴岁已收硕果	宏图大展鸡年更上新阶
闻鸡启步骏马迎春跃	踏雪过年葵花向日开
燕剪穿云裁出三春美景	鸡声唱晓迎来五谷丰年
三界鸡鸣传丰收喜讯	新春燕舞报幸福佳音
玉宇回春初绽红梅四五朵	金鸡报晓乍闻爆竹两三声
雄鸡一二声人间尽晓	瑞雪三五片天下皆春
玉兔东升千江有水千江月	金鸡晓唱万户朝阳万户春
瑞雪纷飞喜庆丰收岁	金鸡起舞欢歌幸福年
北斗回寅万户金鸡争唱晓	东风送暖一双紫燕喜迎春
大业奋群英闻鸡起舞	小康唤诸雄策马前驱
猴岁呈祥，长空五光十色	鸡年纳福，大地万紫千红
岁月更新金鸡啼日出	河山生色紫燕报春归
除夕猴回山，重享齐天乐	迎春鸡报晓，高唱东方红
金鸡报稔千家美酒千家醉	瑞雪迎春万树梅花万树香
瑞雪含春装点山河多锦绣	雄鸡唱晓唤醒大地更妖娆
紫燕街泥又筑新巢喧宅第	金鸡唱晓频传喜讯到城乡
猴去鸡来，胜利年终迎胜利	莺歌燕舞，腾飞岁席再腾飞
金鸡唱晓万里朝霞捧旭日	喜鹊登枝满天瑞雪艳红梅
试看好河山处处被金鸡唤醒	且听新消息天天从玉宇飞来
春满神州山欢水笑迎春节	鸡鸣盛世燕舞莺歌庆鸡年
雏风发清音继起群英肩大任	雄鸡舒劲羽革新一族接春光
骏马迎春沿途尽赏山川美	雄鸡献岁昂首高歌世纪新
瑞雪映丰年稻黄棉白千畴景	金鸡唱赤县水绿山青四海春
猴挥新棒震西天西天颔首	鸡唱初阳赞东岳东岳扬眉
捷报频传，圣猴舞棒辞岁去	宏图再展，金鸡高唱迎春来
醒狮一吼地动山摇震寰宇	雄鸡三唱人欢马叫展宏图
鸡唱三通，万家春正乾坤气	凤鸣两岸，一树梅开天地心
紫燕迎春，一路东风歌大治	金鸡唱晓，九州时雨润小康
雷震南天，滚滚春潮生九域	鸡鸣大地，彤彤旭日耀寰球
神猴辞岁，保驾护航奔富路	金鸡迎春，昂头振翼唱东风
大启明轩纳四海春风五洲霁月	宏开特色听九天鸡唱万里龙吟
人寿年丰，金猴辞岁归帘洞	民安国泰，玉羽司晨报晓春
问燕寻春燕曰春天就在人心里	听鸡报晓鸡言晓日原擎我手中
雄鸡唱韵，万户桃符新气象	大地回春，群山霞彩富神州
振翅欲冲霄，一唱雄鸡声破晓	迎春思试剑，三擂战鼓气吞虹
大业方兴，五星旗展金鸡唱	小康在望，四化图开彩凤飞
九域涌新潮，四海雄鸡争唱晓	三春辉紫气，八方彩凤共朝阳
鸡唱门庭，四海升平歌舜日	犬蹲院里，九州盛世乐尧天
鸡鸣曙日红，万里金光辉瑞霭	柳舞春江绿，千重锦浪映丹霞
鸡唱月归，一线长天皆瑞霭	犬歌日出，九州大地尽朝晖
鸡携竹叶去	犬踏梅香来
戌刻花灯亮	狗年喜气盈
金鸡争报晓	玉犬喜迎春
白梅凌雪尽	黄耳报春来
犬厉堪欺虎	鱼灵巧化龙
春晓金鸡唱	岁宁黄耳勤
金鸡歌国泰	义犬报民安
燕剪千丛锦	犬迎万户春
花犬观鱼乐	青云羡鸟飞
金鸡报捷去	锦犬送春来
金鸡追竹叶	黄耳踏梅花
犬守太平世	梅开如意春
鸡舞三多日	犬迎五福春
金鸡歌晓旦	玉狗问平安
春来燕子舞	犬献雪梅图
犬护祥和宅	人过幸福年
金鸡辞禹甸	玉犬乐尧天
春眠强国梦	犬护富民家
春光明盛世	玉犬贺新年
户展新春景	家传义犬图
犬献梅花赋	鸡留竹叶图
德禽鸣福寿	义犬保平安
犬守平安日	梅开如意春
鸡鸣知日上	犬吠报春来
玉鸡迎晓日	黄犬唤春风
狐从官道过	犬刺客门开
戌日呈帧瑞	狗年臻福祥
鹿衔长寿草	犬踏报春花
月明柳下虫鱼静	日照人间鸡犬喧
丰年富足人欢笑	盛世平安犬不惊
九州日月开春景	四海笙歌颂狗年
四季平安黄犬誉	九州锦绣玉龙飞
戌岁兆丰千囤满	狗年祝福四时安
日新月异雄鸡去	国泰民安玉犬来
报晓司晨辞旧岁	尽忠守夜接新班
犬守家门门有喜	毫敷毛笔笔生花
犬吠鸡鸣春灿烂	莺歌燕舞景妖娆
鸡岁已登千仞塔	犬年更上一层楼
鸡因富裕纵情唱	犬为平安放胆眠
三多竹叶雄鸡画	五福梅花义犬描
犬踏霜桥迎五福	鸡登雪石报三多
犬卧宅阶知地暖	鹊登梅萼报春新
犬守门庭何叫苦	马驰远路不辞难
春风六九观狮舞	气象万千乐狗年
疏柳鸣莺千谷静	新春卧犬一村安
犬看门户民长泰	法治国家世永春
神犬看门门户泰	宏钟警世世风清
瑞雪翩翩兆稔景	犬蹄朵朵报春花
方观竹叶舒鸡爪	又赏梅花印犬蹄
锦鸡报捷摇金步	黄犬迎春跃玉阶
鹤鸣松柏人丁旺	犬守门庭社稷安
戌时火树银花夜	狗岁丰衣足食人
稔岁金鸡舒健羽	新春义犬守华门
狗为宠物成时尚	鹊报福音过大年
年逢大有牛羊壮	国步小康鸡犬宁
新春玉犬门前卧	华夏金龙天外飞
金鸡有信鸣新日	玉犬无私守旧家
鸡鸣岁尾千家乐	犬吠年头万户安
春光明媚燕莺舞	社会文明鸡犬宁
满门结彩春花放	举世澄明玉犬来
警犬擒凶臻大治	神龙强国起宏图
柳浪闻莺千里秀	春台卧犬万家安
新年伊始山川秀	玉犬初临日月长
金鸡报晓迎春至	黄犬守更接福来
风流一代玩狮夜	气象千端入犬年
月异日新鸡报晓	年祥岁吉犬开门
警犬扬威镇腐恶	神龙得志叱风云
戌岁兆丰百事顺	狗年祝福四时宁
龙翔华夏迎新岁	气搏云天奋犬年
戌岁祝福万事顺	狗年兆丰五谷香
犬吠鸡鸣春灿灿	莺歌燕舞日瞳瞳
犬卧阶眠知地湿	鸟临窗语报天晴
鸡追日月雄风舞	狗跃山河瑞气生
月明松下房栊静	日照云中鸡犬喧
国富民强缘改革	鸡鸣犬吠报升平
狗护一门喜无恙	人勤四季庆有余
雄犬偏能欺得虎	黄沙自可变成金
犬画红梅臻五福	鸡题翠竹报三多
日新月异鸡报晓	岁吉年祥狗看门
警犬擒凶功可誉	群龙除孽世能昌
金鸡报捷梅花俏	义犬迎春柳色新
金鸡刚唱丰收曲	黄犬又开富裕门
金鸡献瑞饮郅治	玉犬呈祥展宏猷
辞旧灵鸡歌日丽	迎新瑞犬报年丰
甲第张灯光吉庆	戌时焕彩乐祯祥
戌犬腾欢迎胜利	酉鸡起舞庆荣归
鸡为岁归留竹叶	犬因春到献梅花
四海升平花荫卧犬	五湖秀丽柳浪闻莺
鸡司晨阳光灿烂前程似锦	犬守夜岁月峥嵘美景如春
去岁鸡司晨风调雨顺	今年犬守夜国泰民安
神犬续天鸡九州吟雪尤吟岁	新春临大节万众拜年不拜金
除旧鸡鸣唱出光明盛世	迎新犬吠传来改革佳音
腊酒谢金鸡，唱遍神州歌大有	春风催吉犬，迈开健步跃高峰
六畜猪为宝	四时春最新
虽属生肖后	却居六畜先
生财猪拱户	致富燕迎春
猪年兴旺	槽头发财
亥来四季美	猪献满身肥
人开致富路	猪拱发财门
农户百猪乐	神州万象新
猪年春意闹	龙舞国威扬
春丽花如锦	猪肥粮似山
猪拱财源旺	龙腾国运昌
猪血红泥地	羊脂白玉天
天狗驱寒尽	宝猪带暖春
猪肥粮茂盛	民富国昌隆
猪肥家业旺	春好福源长
阳春臻六顺	猪岁报三多
狗守太平岁	猪牵富裕年
养猪能致富	放鹤可延年
猪是家中宝	粪为地里金
亥时春入户	猪岁喜盈门
守家劳工狗	致富有金豕
猪拱门如意	鸡鸣岁吉祥
亥时看入门	猪岁喜盈庭
养猪能致富	有志莫忧贫
守家夸玉犬	致富赞金猪
猪是农家宝	龙为中国根
猪大能如象	肥多可胜金
天好地好春更好	猪多粮多福愈多
吉日生财猪拱户	新春纳福鹊登梅
朱门北启新春色	紫气东来大吉祥
猪为六畜首	农乃百业基
人增福寿年增岁	鱼满池塘猪满栏
丰稔岁中猪领赏	新台阶上步登高
人逢盛世情无限	猪拱华门岁有余
名题雁塔登金榜	猪拱华门报吉祥
狗问平安随腊去	猪生财富报春来
狗年已展千重锦	猪岁再登百步楼
金榜题名光耀第	喜猪拱户院生财
科技财神尊上座	吉祥猪崽报新春
朱红春帖千门瑞	翠绿柳风万户新
猪拱家门窗贴画	鹿衔寿草福临门
孟春之月方营室	宝盖进豕恰是家
狗岁已赢十段锦	猪年更上一层楼
猪是财神登万户	燕为春使舞千家
燕衔喜信春光好	猪拱财门幸福长
狗蹲户外家长泰	猪拱门前户发财
景象升平开泰运	金猪如意拱财源
爆竹升天送狗岁	春花遍地缀猪牛
洽逢盛世猪如象	喜庆新春鱼化龙
瑞雪纷飞清玉宇	花猪起舞贺新年
腾龙跃马逢新世	送犬迎猪贺大年
两年半夜分新旧	万众齐欢接亥春
花香鸟语春无限	沃土肥田猪有功
景象承平开泰运	猪肥如意获丰收
猪增财富新春喜	燕舞祥和旧主欢
狗守家门旧主喜	猪增财富新春欢
时势安定蔚景象	猪年如意获丰收
瑞雪光丰六瓣锦	年猪吉利一刀清
骚人乐撰新春对	墨客欣书亥岁联
狗岁已赢十段锦	豕年更上一层楼
猪多粮足农家富	子孝孙贤亲寿高
戌年引导小康路	亥岁迎来锦绣春
狗守家门太平无事	猪承财宝富足有余
猪子一身皆是宝	亥年万事俱呈金
骏马金鞍跨上康庄路	肥猪元宝迎来大丰年
昨夕犬年欢歌迎大地	今朝猪岁新景满神州
岁将更始	时乃日新
天心随律转	人事逐年新
节日人共乐	神州地皆春
一元复始	万象更新
欢天喜地	吐气扬眉
一夜连双岁	五更分两年
腊随一夜去	春逐五更来
喜辞旧岁	笑迎新春
腊梅朵朵迎新岁	瑞雪飘飘兆丰年
一年复始九州同庆	八方和协四季平安
一年春作首	万事公为先
天开美景春光好	人庆丰年节气和
元起于一一心创业	旦即是朝朝气如春
国强家富人寿	花好月圆年丰
载歌载舞辞旧岁	自唱自乐迎新年
国历欣逢元旦节	新春合放自由花
五夜通明	天开美景
风清月朗	灯彩星辉
月光皎洁	银烛辉煌
万户鼓吹	银光有焰
一团拥宝炬	千点灿银星
巧人调玉烛	天下乐元宵
星桥铁锁	火树银花
树梢银花	心上春意
灯月千家晓	笙歌万户春
锦城灯结彩	花市月含华
火树银花合	星桥铁锁开
万家元宵夜	一街太平歌
灯楼灿明月	火树暖春风
天上一轮满	人间万里明
放手擎明月	开心乐元宵
明月千门雪	银灯万树花
九陌连灯彩	千门庆月华
花市千门月	灯街万户春
雪月梅柳开春景	花灯龙鼓闹元宵
天空明月三千界	人醉春光十二楼
笙歌声沸长春地	星月光映不夜天
一曲笙歌春似海	千门灯火夜如年
火树光腾城不夜	银花焰吐景长春
街头灯影逐花影	村中梅香伴酒香
万里春灯元夕宴	满街灯火太平歌
万家灯火同秋月	大地光明不夜天
中天皓月明世界	遍地笙歌乐团圆
三五星桥连月圆	万千灯火彻天街
玉烛长调千门乐	花灯遍照万户明
灯同月色连天照	花怯春寒傍火开
玉宇无尘千倾碧	银花有焰万家春
匝地楼台春富贵	喧天歌舞夜风流
万里河山铺锦绣	满城管弦乐太平
寒笳送走人间腊	晓角吹回雪里春
火树银花富贵色	良宵美景太平春
明月皎皎千门秀	华灯盏盏万户春
一帘春色门垂柳	万斛珠光地涌莲
及时大放光明夜	与物同游浩荡天
银花火树开佳节	紫气丹光拥玉台
光腾月殿流蟾魄	花灿星桥吐凤文
玉宇无尘一轮月	银花有艳万点灯
晴空一镜悬明月	夜市千灯照碧云
万户管弦歌盛世	满天焰火耀春光
喜地欢天饮美酒	张灯结彩市元宵
轮影暂移花树下	镜光如挂玉楼头
灯火交辉元夜里	笙歌簇拥月明中
明烛送来千树玉	彩云移下一天星
溶溶月夜连灯市	霭霭春光满夜城
飞龙舞凤成夜市	击鼓踏歌皆春声
天空明月一轮照	人醉春风万里明
碧树银台万种色	野花啼鸟一般春
三千世界笙歌里	十二都城锦绣中
赏灯极乐繁华地	秉灯同游不夜天
美人何处教歌舞	上将今宵夺昆仑
玉宇尘清一轮皓月	银花焰吐万盏春灯
明月一轮天开清淑	春灯万盏人乐太平
灯火万家良宵美景	笙歌一曲盛世元音
远景近景良宵美景	礼花鲜花火树银花
良辰三八节	妇女半边天
三八宏图展	九州春意浓
凤毛春济美	麟趾贵呈祥
昔日女界多贡献	当今巾帼再登攀
壮志结成四化果	红心顶起半边天
争当三八红旗手	敢胜九州铁血男
中华巾帼多奇志	当代女流胜伟男
树新风三八红旗飘万代	立壮志四化伟业拼一生
为妇女扬眉吐气	与男儿并驾争雄
祖国腾飞巾帼英雄创大业	神州巨变中华儿女展宏图
植树造林滋沃土	防风固水护良田
春夏秋冬四季绿	东西南北九州香
造林植树山川秀	种草栽花庭院香
处处造林林似海	家家植树树成荫
喜观树海葱茏日	笑见山花烂漫时
敢教荒山成绿海	誓将沙漠变青川
绿荫祖国处处山青水秀	改造自然年年林茂粮丰
树木对人同系千秋大业	爱家爱国常昭一片丹心
屋前宅后栽树延年益寿	隙地荒山造林利国富民
年年绿化造林无山不翠	岁岁蒙荫植树有地皆春
二月芳辰多胜景	百花诞日是今朝
百花齐放	四海同春
花香蝶飞舞	鸟语日初长
爱竹不除当路笋	惜花留得拂面枝
花馨溢佳节	香风漫早春
让丛丛绿树绿遍文明城市	叫簇簇香花香满美好乐园
继往开来追壮志	先前裕后慰英灵
相逢马上纷桃雨	喜见树前问杏花
先烈功垂千古	英明留传万年
槐火光明春替换	杏花消息雨传知
燕子来时新春	梨花落后清明
禁火今年逢春早	飞花锁日为人忙
寒食雨传百五日	花信飞来廿四春
睹物思亲常入梦	训言在耳犹记心
三月光阴槐火换	雨意前村市杏花
姓在名在人不在	思亲想亲不见亲
秀野踏青晨行早	芳草拾翠暮忘归
克勤称美德	劳动最光荣
掌握科学规律	发扬改革精神
鲜花献模范	美酒敬英雄
敢想敢为齐奋勇	克勤克俭共腾飞
雄心勇奋三连冠	壮志同描四化图
四化宏图酬壮志	两番大业树雄心
策马登程奔四化	闻鸡起舞有群英
挥毫共写英雄谱	展卷特书大业章
十亿同心鹏展翅	九州昂首马腾蹄
进取途中多志士	拼搏场上尽英雄
倒海移山豪情永在	改天换地其乐无穷
四化宏图呈曙色	千秋大举布春光
创业凯歌起	攻关胆气生
青春红似火	大志壮如山
当青年闯将	做时代英雄
一代新风树	百年大计兴
五四精神惊百代	万千美景待一笔
开华夏千秋盛举	展神州万古雄风
四有新人兴大举	八方俊秀绘宏图
莫让韶光付逝水	宜将烈火燃青春
时代青年耀今烁古	新兴事业继往开来
一代英豪九州生色	八方儿女四海为家
三春雨露共荣万树	一代风流同振九州
天中令节	地腊良辰
日逢重午	节序天中
保艾思君子	依蒲祝圣人
辰振逢地腊	建午届中天
门幸无题午	人渐不识丁
艾草飞香午门纳福	龙舟竞渡万水欢歌
榴裙萱黛增颜色	艾酒蒲浆记岁华
结艾钦头轻战虎	夺标船首惯乘龙
海国中天魂招屈子	江城五月笑看龙舟
绿艾悬门添藻彩	青蒲注酒溢芬芒
艾叶电旗招百福	菖蒲似剑斩千妖
画鼓朱旗锦标齐村	香罗细葛纱服新成
艾人驱瘴千门福	碧水竞舟十里欢
石榴映红日千门喜庆	鼓乐催龙舟万水欢歌
节启朱明榴花献瑞	盘陈角黍蒲酒怀贤
代代龙舟竞渡追怀屈子	年年角黍投江祭奠诗魂
艾叶吐幽芳香溢四海	龙舟掀巨浪气吞八荒
龙舟竞渡凭吊屈子怀石恨	赤县雄飞喜谱今朝爱国篇
美酒雄黄正气独能消五毒	锦标夺紫遗风犹自说三闾
续传接力棒	浇灌向阳花
早立凌云志	誓当接力人
千秋折桂手	一代接班人
祖国新花朵	未来小主人
三好学生明志远	一旗火炬映心红
学习勤奋争三好	德智优良树一流
年少宏图远	鸟雏志向高
抚育校园新花朵	培植祖国栋梁材
创建千秋大业	栽培一代新人
绽蕾花树株株秀	破土春笋节节高
幼苗逢喜雨百花吐艳	新树度春风万木争荣
六一儿童欢度节	万千花朵正宜人
共产党恩泽四海	毛主席名重千秋
政策英明开盛世	党风纯正惠民心
党恩春荡荡	家庆日融融
爱党心诚葵向日	孚民德重凤朝阳
国运昌隆民做主	人心欢愉党擎旗
花木向阳春不老	人民跟党志难移
马列光华昭大地	人民伟业启新猷
岁月逢春花遍地	人民有党志登天
政策光辉昭日月	人民智慧焕河山
桥填五夜来喜鹊	河渡双星会女牛
五夜照天汉	双星会女牛
莫谓人间多别恨	便疑天上有离愁
帝女合欢水仙含笑	牵牛迎辇翠鹊凌霄
鹊桥星度夜	燕馆月沉时
牛女二星河左右	参商两曜斗西东
银汉碧波凉生七夕	金钗钿盒夜拜双星
针好穿三孔	书宜曝五车
宏谋抒啸虎	士气奋扬鹰
山海金汤固	官兵铁铠寒
炮火慑敌胆	钢枪振国威
祖国铁龙阵	人民子弟兵
八一军旗红海宇	万千劲旅壮河山
天地有情留正气	江山无患慰忠魂
秉丹心报国	举赤手擎天
光荣传统光荣史	钢铁长城钢铁兵
军号入云添斗志	战旗映日动豪情
钢铁长城固	英雄军队坚
战士军中传捷报	英雄故里庆和平
白云丹桂边关色	明月清风将士心
热血洒疆土	铁臂筑长城
尊师重教	育才兴邦
催笋成竹	润花著果
碧血催桃李	丹心树栋梁
为国而教	作人之师
人才要靠教育培养	智力须从幼时开发
碧血育桃李	辛勤扶栋梁
栋梁砥大厦	桃李芳九州
愿作园丁勤浇灌	甘为烛炬尽燃烧
重教导师人文蔚起	育才献智国运昌隆
人梯巧搭登攀路	心血勤浇栋梁材
毕生心血哺新秀	一代桃李谱华章
讲台展开千秋画卷	宝岛绽放万树蓓蕾
千篇新诗园丁赞	万首衷曲育人歌
举国尊师兴伟业	栉风沐雨做园丁
为人师表诲而不倦	替国树才教必有方
丹心一片育新苗	赞歌千曲颂园丁
愿作人梯育新秀	甘为孺子当黄牛
展宏图基础是教育	起新步关键在人才
且喜满园桃李艳	莫悲两鬓霜雪寒
旭日灿星照学府	春风化雨育新苗
育才兴邦百年大计	尊师重教一代新风
国家辛勤一堂秀	桃李成荫四海春
热汗染成千顷绿	丹心育出万代红
春蚕巧织满园锦绣	红烛点燃一代心灵
培育名花香天下	造就栋梁建中华
终身育才人人敬	红烛火种代代传
立足本职献身教育	为人师表无尚光荣
尘中人自老	天际月常明
春秋多佳日	山水有清香
天上一轮满	人间万里明
明月映天	甘露被宇
露从今夜白	月是故乡明
二仪含皎洁	四海尽澄清
明月本无价	高山皆有情
一天秋似水	满地月如霜
中天一轮满	秋野万里香
冰壶含雪魄	银汉漾金波
薄惟鉴明月	高情属云天
皓月无幽意	清风有激情
半夜二更半	中秋八月中
亭空千霜月	水续万古流
霓裳舞起终宵朗	玉女歌扬彻夜辉
叶脱疏桐秋正半	花开丛桂树齐香
一逢喜事精神爽	月到中秋光辉增
笙歌曲中千家月	红藕香里万颗珠
轮影渐移花树下	镜光如挂玉楼头
三五良宵开玉宇	大千世界涌冰轮
日射晚霞金世界	月临天宇玉乾坤
鱼戏平湖穿远岫	雁鸣秋月写长天
爆竹声中千家月	红藕香里万颗珠
月静池塘桐叶影	风摇庭幕桂花香
喜得天开清旷域	宛然人在广寒官
一曲霓裳传玉笛	四围云锦拥金徽
黄菊绮风村酒熟	紫门临水稻花香
夏至本逢三伏热	重阳戊遇一冬晴
鼓琴仙度曲	种杏客传书
步步登高开视野	年年重九胜春光
三径归时秋菊在	满城近日雨风多
临风鸟帽落	送酒白衣香
何处题糕酬锦句	有人送酒对黄花
菊花早放铺金蕊	桑叶新开泻玉缸
东篱开寿菊	南陌献嘉禾
孟参军龙山落帽	陶居士三径衔杯
败兴无端满城风雨	登高何处插鬓茱萸
靖节排冠归隐去	孟生落帽快登临
山欢水笑	物阜民康
国光勃发	民气旺苏
普天同庆	日月增辉
江山永固	日月长恒
国趋昌盛人趋富	花爱阳春果爱秋
举国英豪开新局	中天丽日庆长春
山河千古秀	平野万象新
人逢国庆精神爽	月到中秋分外明
鹰疾如箭凌云志	花红似火报国心
前程千帆竞发	盛世万象更新
东风入户	喜气盈门
革命伴侣	幸福家庭
雁鸣旭日	凤哕朝阳
夫妻恩爱	家庭幸福
白头偕老	同心永结
珠联璧合	凤翥鸾翔
天作之合	文定厥祥
云开五色	户拱三星
礼行平等	结婚自由
鸳鸯比翼	夫妻同心
凤吉叶占	熊祥入梦
互助互爱	相敬相亲
百年合好	五世其昌
庭呈瑞彩	门挹祥光
百年好合	五世其昌
月明金屋	香喷玉屏
志同道合	花好月圆
禧凝燕贺	庆肇鸿图
花开并蒂	偶结同心
双燕齐飞	阖家欢乐
良辰美景	赏心悦事
行文明礼	结自由婚
萧迎淑女	酒贺新郎
凤凰鸣矣	琴瑟友之
夫妻恩爱	琴瑟和弦
鸳鸯对舞	鸾凤和鸣
雁鸣旭旦	凤哕朝阳
三星并耀	五世其昌
夫妻恩爱	鸾凤和鸣
花开并蒂	缘结同心
芝兰千茂	鸾凤百鸣
印泥发彩	兰蕊浮香
志同道合	意厚情长
天长地久	花好月圆
玉堂双璧合	宝树万枝荣
欢腾彩凤	瑞应祥麟
海誓山盟	同心永结
夫妻恩爱	家庭祥和
双莺鸣高树	对燕舞繁花
诗题红叶	彩耀青鸾
天高地阔	比翼齐飞
互帮互爱	相敬相亲
礼堂新献颂	妆阁合催诗
月圆花好	凤舞龙飞
射屏得偶	种玉有缘
门迎淑女	户接佳宾
百年歌好合	五世卜其昌
书称厘降	诗咏好逑
荷开并蒂	芍结双花
白头偕老	同道永春
当门花并蒂	迎户树交柯
水偕伉俪	喜缔良缘
鸳鸯比翼	龙凤呈祥
蓝田种玉	红叶题诗
旭日辉仁里	祥云护德门
花好月圆	姻缘美满
礼求平等	婚尚自由
乾坤交泰	琴瑟和谐
创业成知己	革命结同心
新人入户	喜气盈门
笙萧奏凤凰	鼓乐迎佳宾
好逑偕伉俪	嘉礼协文明
百年歌好合	两美结良缘
并蒂花最美	同心情更真
绿竹恩爱意	红梅贺新人
祥云腾吉地	瑞气聚华轩
志同配佳偶	道合结良缘
鱼水千年合	芝兰百世荣
琴瑟春常润	人天月共圆
旭日艺兰秀	春风琴瑟和
吹萧堪引凤	攀桂喜乘龙
奇缘谐凤配	雄梦叶熊占
缔美好姻缘	创幸福生活
芝兰茂千载	琴瑟乐百年
鸣琴乐佳偶	鼓瑟缔良缘
建文明社会	结美满婚姻
喜望红梅开	乐迎新人来
琴瑟春常润	花好月共圆
四季花常好	百年月永圆
春融花并蒂	日暖树交柯
摄成双璧影	缔结百年欢
彩笔题鹦鹉	焦桐引凤凰
凤凰为世瑞	琴瑟谱新声
结成平等果	开出自由花
锦瑟调鸿案	香词谱凤台
鸳鸯千载合	鸾凤百年和
文明协嘉礼	家室敦好逑
结革命伴侣	建幸福家庭
新春贺双美	齐飞庆百年
卿云绕绣辇	瑞气霭详云
恋爱心已合	结婚情更浓
烛照香车人	花迎宝扇开
欢歌随凤舞	笑语伴龙腾
同心奔四化	携手上征途
赤绳曾系足	红叶昔题诗
文明办喜事	礼貌待嘉宾
良辰添吉庆	嘉礼占文明
道合感情好	志同幸福多
良夜良辰良缘	佳男佳女佳偶
金凤过清夜	明月闹洞房
红梅思爱意	绿竹贺新人
雀屏欣中目	鸿案举齐眉
志同道合创业	情长谊深成家
三星方在户	百辆正迎门
喜气门庭满	春光绣帐明
玉堂歌燕喜	金屋啭莺娇
菊垂金作客	琴瑟谱新声
但愿情长久	何须语蜜甜
志于云上得	人自月中来
香掩芙蓉帐	烛辉锦绣帏
并蒂莲开四季	比翼鸟喜双飞
俭朴成婚礼	勤劳钟爱情
鸟入同行侣	花开连理技
锦堂双璧合	玉树万枝荣
向阳红花争艳	比翼俊鸟齐飞
齐种爱情树	同当幸福人
祥光拥大道	喜气满庭门
春风琴瑟韵	旭日芝兰香
笑脸笑迎宾客	喜歌喜接新人
并蒂花齐美	同心情更深
喜见红梅放	乐迎淑女来
祥云辉绣辇	瑞气驻华堂
美日美月美意	新郎新娘新婚
云恋妆台晓	花迎宝扇开
金风吹静夜	明月照新房
梅帐同甘梦	兰房送异香
银河双星庆会	金屋大礼观成
琴瑟千年好	江山万代红
共结美满姻缘	同建幸福生活
同德同心同志	知寒知暖知音
喜迎亲朋贵客	欣接伉俪佳人
凤凰鸣瑞世	梅点玉为容
但求志同道合	何必户对门当
欣接亲朋贵客	喜迎伉俪佳人
道合志同建国	情长意重齐家
情长谊深成家	志同道合建国
喜听琴瑟合奏	欣看凤凰齐飞
何必门当户对	但求道合志同
栏外红梅竞放	檐前紫燕双飞
美鸳鸯看比翼	好夫妇结同心
九畹兰香花并蒂	千树梧碧凤双栖
五色云临门似彩	四化志铭心如磐
喜共花容月色	何分秋夜春宵
小梅香里黄莺啭	玉树阴中紫凤来
互敬互爱春永驻	同心同德乐无穷
银汉双星庆会	金凤大礼欢成
山青水碧风光美	酒绿灯红喜气多
云汉桥成牛女渡	春台萧引凤凰飞
一对鸳鸯成好梦	五更鸾凤换新声
万里云天看比翼	百年事业结同心
云抱玉林芝草茁	香飘金屋篆烟清
一对红心向四化	两双巧手绘宏图
夫妻同心建四化	鸳鸯比翼奔长征
云路高翔比翼鸟	龙池深种并蒂莲
二姓联盟成大礼	百年偕老乐长春
友情培植常青树	恩爱催开幸福花
长天欢翔比翼鸟	大地喜结连理枝
十里好花迎淑女	一庭芳草长宜男
百年恩爱双心结	千里姻缘一线牵
午夜鸡鸣欣起舞	百年举案喜齐眉
佳偶百年欣遇	知音千里相逢
玉树风前夸并倚	绣帏月里看双飞
向阳红莲并蒂开	朝阳彩凤比翼飞
今日结成幸福侣	毕生描绘锦绣图
兰浥瑶阶花并蒂	光耀华屋户三星
今日结成并蒂莲	明朝共栽幸福花
百岁夫妻常合好	千秋伴侣永和谐
对对莲开映碧水	双双蝶舞乘东风
合欢花花花欢合	双飞燕燕燕双飞
杯交玉液飞鹦鹉	乐奏瑶笙引凤凰
吉人吉时传古语	新人新岁结新婚
文挥锦绣珠垂璧	粉傅兰胸云压梅
两朵红花争艳丽	一对鸳鸯比翼飞
百子帐开留半臂	五丝缕细结同心
并肩同走幸福路	携手共绘锦绣春
双飞黄鹂鸣翠柳	并蒂红莲映碧波
百年佳偶今朝合	万载良缘此日成
汗水共浇理想树	勤奋共尝爱情果
正是驾歌燕舞日	恰逢花好月圆时
两情鱼水春作伴	百年恩爱花常红
金屋春浓花馥郁	琼楼夜永月团圆
欢庆此日成佳偶	且喜今朝结良缘
连理枝结同心果	比翼鸟奔四化程
和睦门庭风光好	恩爱夫妻幸福长
红叶题诗欣赠嫁	青梅煮酒庆于归
迎东风双燕飞舞	向旭日并蒂花开
金鸡昂首祝婚礼	喜鹊登梅报佳音
红花并蒂相映美	矫燕双飞试比高
良缘喜结鸳鸯谱	春色永驻劳动家
宜国宜家新妇女	能文能武好男儿
志向远大双飞燕	花香艳丽并蒂莲
相亲相爱新伴侣	互帮互学好夫妻
赤诚招来飞鸿落	深情激得玉石开
海阔天空双比翼	月圆花好两知心
青丝共少最亲热	白头偕老更恩爱
桃符新换迎春帖	椒酒还斟合卺杯
花好月圆欣喜日	桃红柳绿幸福时
画眉笔带凌云气	种玉人怀咏雪才
柳暗花明春正半	珠联璧合影成双
花深处鸳鸯并立	稀枝间凤凰共栖
画眉喜有临川笔	举案欲看德耀妆
花月新妆宜学柳	芸窗学友早栽兰
革命佳偶同心结	并蒂红花向党开
家庭和睦歌声溢	琴瑟相偕乐事多
联翩丹凤舒新翼	并蒂红花攀高枝
举案齐眉示互敬	既婚仍友自相亲
银镜台前人似玉	金鸾堂中语如花
喜酒喜糖办喜事	新春新岁迎新人
载雪梅花飘绣阁	临风兰韵入香帏
情歌唤醒水中月	喜酒润开庭前花
喜鹊喜期报喜讯	新春新燕闹新房
莫道无才便是德	须知治国在齐家
鸾凤双栖桃花岸	莺燕对舞艳阳天
爱情红花开四季	姻缘美果甜百年
爱长长得长长爱	情深深知深深情
鸾凤和鸣昌百世	鸳鸯合好庆三春
新岁新婚新起点	喜人喜事喜开端
爱情贤贞花正好	意气相投月常圆
鸾凤和鸣昌百世	麒麟瑞叶庆千龄
爱情因事业增美	青春靠知识闪光
一对佳人兴大业	万千志士振中华
堂上画屏开孔雀	闺中绣幕隐芙蓉
携手栽培长青树	精心浇灌爱情花
爱情凭忠诚美好	力量靠理想发光
玉宇欣看金鹤舞	画堂喜听彩鸾鸣
大雁比翼飞万里	夫妻同心乐百年
碧岸雨收莺语柳	蓝田日暖玉生烟
叶笙簧百年偕老	鼓琴瑟五世其昌
千载情谊春永驻	百年恩爱花常红
喜鹊争鸣报喜讯	新花竞放迎新人
欢情永系同心带	春意先临并蒂梅
孔雀开屏月初圆	芙蓉出水花正好
红杏枝头春意闹	绿杨桥上玉人来
魁星常耀书香第	祥云时护积善家
丹桂香飘云路近	玉萧声绕镜台高
蝶趁春光欣结伴	人逢盛世喜成亲
万载良缘此日成	百年佳偶今朝合
长杨日暖祥光集	细柳风高喜气融
大好年华歌好合	丰饶世景结良缘
同心结闪红叶色	连理花飘金桂香
红花并蒂相映美	紫燕双飞互比高
枝头梅绽春来早	堂前榴开福满门
杏坛春暖花并蒂	兰闺日晴燕双飞
百年佳偶同心结	万里鹏程比翼飞
相敬如宾四季乐	钟情似海百年长
柳树花明春正好	珠联璧合影成双
佳儿佳女成佳偶	春日春人舞春风
互敬互爱好伴侣	同心同德美德缘
志趣相投花亦笑	感情融洽月常圆
意似鸳鸯飞比翼	情如鸾凤宿同林
爱貌爱才尤爱志	知人知面更知心
喜看两小成佳偶	乐生一个树新风
莺声日暖鸣金谷	麟趾春深步玉堂
银镜台前人似玉	茜纱窗下语如诗
婚礼只须歌燕尔	计生不复咏螽斯
良缘永结心花放	喜气方升岁月欢
琴瑟同奏幸福曲	夫妻共描锦宏图
谙人谙世能经国	亦淑亦贤最可人
水底月为天上月	眼前人是意中人
勤劳手足忧患少	恩爱夫妻欢乐多
如意香生红玉宇	明珠光入紫微垣
引凤才高应跨凤	屠龙技绝自乘龙
燕舞莺歌春得意	志同道合遂初心
岂只室家盟自首	更为时代奋青春
绣阁凰和箫引凤	蓝田日暖玉生烟
红妆带绾同心结	碧池莲开连理技
窗前共揽三春月	灯下同吟一卷诗
昔日同栽连理树	今朝共举合欢杯
爱有缘由情有种	学无止境业无穷
同跨骏马驰千里	共植梅花乐百年
天上笑看星伴月	人间喜见凤求凰
十里好花迎淑女	一庭芳草贺新郎
今日画眉春在手	他年攀桂月当头
金屋笙歌偕卜凤	洞房花烛喜乘龙
琴瑟永偕四化曲	芝兰同茂百年春
双星牛女窥银河	并蒂芙蓉映彩霞
琼楼月皎白如玉	绣阁花香酒似诗
碧沼红莲开并蒂	芸窗学友结同心
丹山凤凰双飞翼	东阁梅开并蒂花
凤落梧桐梧落凤	珠联璧合璧联珠
门对青山含远翠	窗含嫩柳画浓眉
偕老佳偶同心结	并蒂花开向阳红
共举红旗兴骏业	相期白首缔鸳盟
瑶琴喜奏凰求凤	玉笛横吹蝶恋花
巧借花容添月色	欣逢秋夜作春宵
欣逢佳节迎淑女	聊备村醪谢亲朋
百年佳侣今朝合	两姓良缘此日成
种就福田如意玉	养成心地吉祥云
皓月描成双剪影	寒霜映出并头莲
月下彩娥欣咏凤	云间仙客真乘龙
芙蓉镜映花含笑	玳瑁筵开酒合欢
庆良缘山欢水笑	成佳偶女淑郎才
伉俪好和般般好	家庭新建样样新
喜看伴侣偕欢日	恰是风华正茂时
笙歌彻夜香车迓	箫鼓元宵宝镜圆
日暖金兰来群燕	春玉和柳发新枝
起舞花间娱倩影	但闻天外遏行云
堂前奏笛迎宾客	户外吹箫引凤凰
向阳红莲开并蒂	朝阳彩凤吉双飞
芙蓉出水花正好	孔雀开屏月初圆
鸾妆并倚人如玉	燕婉同歌韵似琴
喜结鸳盟同咏月	壮怀鹏志共凌云
海誓山盟期百岁	情投意合乐千觞
花好月圆羡比翼	天长地久卜齐眉
莲子杯中金谷酒	桃花盏上玉台诗
凤凰枝上花似锦	松菊堂前人比肩
三星在户临花烛	百车盈门灿锦幄
共图家国平章事	同咏河洲窈窕篇
碧纱待月春调瑟	红袖添香夜读书
画堂春暖宫花艳	绣阁官清风管调
碧海云生龙对舞	丹山日出凤双飞
天结良缘绵百世	夙成佳偶肇三多
金鸾集规模壮丽	银燕临栋宇嵯峨
自去自来梁上燕	相亲相近水中鸥
春润乾坤花吐艳	情传华宇燕归梁
梅楼翡翠开相语	镜水鸳鸯暖共游
一岭桃花红锦绣	万盏银灯引玉人
红梅吐艳迎淑女	美酒飘香酬嘉宾
爱情坚贞花正好	志趣融洽月常圆
银河驾鹊欢今夕	绣幄迎鸾叶吉期
月映芙蓉开并蒂	春明莺燕喜双飞
春临玉树千枝发	日映华堂紫燕栖
香花笑迎灯结彩	喜气入户月初圆
吉日花开梅并蒂	良宵家庆月双圆
院内梅花迎岁绽	门前萱草贺春荣
探花幸际辰初夏	梦燕欣逢麦至秋
并蒂莲开莲蒂并	双飞燕侣燕双飞
鹏御春风游字内	凤迎旭日舞门前
菱花光映纱窗晓	竹叶香浮绣户春
菱花绶带鸳鸯簇	金屋屏风孔雀间
春风堂上初来燕	细雨庭前新种花
花朝春色光花烛	柳絮奇姿画柳眉
盈耳笙歌交玉液	满堂花烛引香车
国有贤才扶世运	光摇烛影看新人
并肩齐建千秋业	携手同绘四化图
鸳鸯相戏水色美	琴瑟偕弹福音多
互尊互敬乾坤大	相爱相亲日月长
梅花芳讯先试春	柳絮吟杯小雪初
花烛交心齐勉志	新婚携手共图强
堂栖彩燕双星耀	岭放红梅万象新
鸿雁贺喜衔霜叶	秋风迎亲带桂香
笔墨今宵光更艳	梨花带雨晚尤香
百事开怀百事咏	两心相重两心知
银烛光浮元月夜	紫箫吹彻玉堂春
和谐共处姻缘好	恩爱相亲乐事多
并蒂花开喜二美	同心果结颂百年
丽日神州开四化	春风良夜渡双星
松梅高傲坚贞爱	霜雪难欺金玉缘
移风举办新婚礼	为国优生大厦才
爱情纯正纯情爱	婚礼简朴简礼婚
琴瑟谐和歌盛世	夫妻友爱颂丰年
容貌心灵双媲美	才华事业两竞新
青梅竹马男偕女	海誓山盟女嫁男
谊如汩汩长流水	情似苍苍不老松
华夏腾飞同振翼	征途奋起共扬鞭
志同道合真平等	地久天长永自由
爱海并游须勉励	征途同步共攀登
门书喜字乾坤大	户进新人岁月甜
满座嘉宾漾喜气	一声花炮报新人
巧借花容添月色	欣为秋鹊架银桥
姻缘缔结三生幸	旖旎平分一半春
秦晋姻缘春意闹	凤鸾伴侣彩虹飞
今夕交杯传蜜意	来朝跃马赛风流
一世光阴今过半	百年伉俪喜成双
勤劳致富须同勉	和睦持家贵相帮
同心同德家邦盛	相爱相亲岁月长
岂只室家盟白首	更为祖国献青春
蝶趁花芳欣作伴	人逢成世喜联姻
两情雨水春为伴	百脉爱丝谊永联
莺燕双栖芳草地	风鸾对舞艳阳天
一朝喜结千年爱	百岁不移半寸心
瑶琴一曲双声奏	月殿三秋五桂香
五夜芝兰徐入梦	百年瓜瓞渐开祥
文窗绣户垂帘幕	银烛金杯映翠眉
新笔曾题红叶句	华堂欣咏友琴章
诗歌四喜其三句	乐奏周南第一章
五色云临门似彩	七香车辗韵如琴
秋镜满轮仪凤侣	晓窗听鼓锦鸡鸣
采莲君子新求偶	雪洁佳人旧有才
琼楼月耀人如玉	绣阁花香酒似兰
紫箫吹玉翔丹凤	翠袖临风舞彩鸾
金鹏举翼凌云上	彩凤含情展翅随
花径不曾缘客扫	蓬门今始为君开
紫云秀绕芙蓉第	玉树花飞玳瑁梁
春窗巧绣鸳鸯谱	夜月香斟琥珀杯
沧海月明珠献彩	蓝田日暖玉生香
爱情纯真月圆花好	目标远大地久天长
黄花艳吐东篱月	丹桂香飘北国诗
花月新妆宜学柳	寒窗好友早栽兰
红梅吐芳喜成连理	绿柳含笑永结同心
满室鲜花清香四溢	几盘水果欢乐一堂
萧彻玉楼声和风侣	花盈金屋香满赡官
凤凰鸣矣梧桐生矣	钟鼓乐之琴瑟友之
燕屋才高诗吟白雪	兰馨芝秀志在九州
好鸟双栖嘉鱼比目	仙葩并蒂瑞木交枝
两门多喜两家多福	一对新人一代新风
海枯石烂同心永结	地阔天高比翼齐飞
金屋才高诗吟白雪	玉台春早妆艳红楼
白首齐后鸳鸯比翼	青阳启瑞桃李同心
牡丹丛中蝴蝶双舞	荷花塘内鸳鸯对歌
爱雅年年年年雅爱	情深岁岁岁岁深情
知识鼓满青春风帆	劳动展开爱情羽翼
互敬互爱互相学习	同心同德同建家庭
同心同德美满夫妻	克勤克俭幸福鸳鸯
鸿案相庄百年偕老	凤占叶吉五世其昌
金玉其心芝兰其室	仁义为友道德为师
革命姻缘情深似海	征途伴侣志洁如梅
俭朴联婚欢偕鱼水	勤劳致富喜溢门庭
喜溢华堂地天交泰	香飘桂苑人月双圆
春暖花朝彩鸯对舞	风和丽日红杏添妆
鸾凤和鸣春光满目	燕莺比翼壮志凌云
燕尔新婚四月维夏	君子偕老百年长春
美酒盈盅嘉宾满座	春风入户喜气临门
瑞彩盈庭嘉宾满座	祥光当户喜气临门
美满婚姻情深意重	和睦家庭地久天长
艳福增添喜成佳偶	新词赞美欢洽来宾
山水怡情福门望重	凤凰娱目鸿案辉生
嫁女婚男处处从简	移风易俗事事当先
才子凌云佳人咏雪	榴花映日蒲叶摇风
尊夫爱妻家庭美满	敬老扶幼生活欢欣
迨其古兮毂我士女	式相好矣宜尔室家
海誓山盟同心永结	地阔天高比翼齐飞
花烛光中山盟海誓	青春路上道合志同
栋赴连云庭悬霁月	堂延爱日座满春风
祥云浮紫阁春风暖	喜气溢朱门全家乐
红梅含笑喜成连理	绿柳吐芳永结同心
彩集凤毛庆衍麟趾	瑞凝芝草祥发桐枝
东阁诗情西昆雅韵	南华秋水北苑春山
红叶题诗蓝田种玉	黄花酿酒黛笔画眉
春日融融红梅朵朵	花香阵阵彩蝶双双
不愿似鸳鸯嬉戏浅水	有志像海燕搏击长风
白雪无尘如纯贞爱意	红梅有信似美好心灵
相亲相爱铁肩担宇宙	同心同德妙手绣江山
爱情并蒂花开开不败	伴侣常偕心乐乐无穷
喜期办喜事喜中有喜	新岁迎新人新上加新
携手绘宏图妙笔生花	并肩兴大业豪情满志
结一世姻缘山盟海誓	祝百年伉俪地久天长
良冶良弓喜箕裘克绍	宜家宜室欣琴瑟新调
白璧种兰田千年好合	红丝牵绣纬万载良缘
白壁种蓝田千年合好	红丝牵绣纬百载良缘
万里长空鸾凤双比翼	百年大业夫妻两同心
绿叶衬红花花繁叶茂	情歌谱新曲曲美歌甜
盛世结良缘火红事业	新人怀壮志高尚情操
办喜事喝喜酒皆大欢喜	结新婚闹新房焕然一新
新社会新人物新婚大喜	好劳动好光景好合百年
东风劲玉宇高鸳鸯比翼	爆竹鸣华灯放龙凤呈祥
新婚新偶新人人人如意	佳期佳景佳时时时称心
节约办婚事亲友皆欢喜	勤俭建家园夫妻更和睦
缔结同心日丽屏间孔雀	莲开并蒂影摇池上鸳鸯
配佳偶两片赤诚行大礼	结良缘百年美满乐长春
新婚新偶新人人人如意	佳丽佳期佳景景景称心
蟾影浮光皓月交明花烛	龙躔应律祥云直逼星桥
手携手建设文明富强祖国	肩并肩创造美满幸福家庭
玉烛生辉喜兆千秋鸾凰	银灯结彩祥言百代鸳鸯
连理花开看今日鸾俦凤侣	宜男草长卜他年麟趾螽斯
新人办新事新风传梓里	春日布春辉春色满庭园
你敬我爱你我好比鸳鸯鸟	情投意合情意恰似连理枝
鱼水情深绿叶红花长相伴	夫妻志笃长征骏马共加鞭
鸟恋林鱼恋水情哥恋情妹	云配月叶配花佳女配佳男
蝶恋花花喜蝶花蝶常作伴	夫敬妻妻爱夫夫妻永相亲
相敬如宾发奋图强百世乐	钟情似海勤劳致富万年长
大地花繁蜂舞蝶飞相与伴	画堂春满燕鸣莺唱总成双
一对鸳鸯湖泊游泳清波水	成双鸾凤森林栖息梧桐枝
结伉俪婚礼从俭八方齐赞	迎新人喜事新办四邻尽欢
相爱相亲家和人寿吉星照	同心同德水秀山青喜事连
相敬如宾好好和和四季乐	钟情似海恩恩爱爱百年长
赐福赐祥结成佳偶今如愿	图强图奋珍惜春光大有为
大地香飘蜂忙蝶戏相为伴	人间春到莺歌燕舞总成双
婚礼从简三杯清茶谢高朋	相敬如宾客莫道妇随夫唱
成才创业志趣相投同地久	情深若战友但求女信男尊
吉日良辰欣相逢佳期迎婿	善男信女喜结缘时尚报春
无物可陪三江四水随身带	有言相赠百好一勤致力行
英才成佳偶杨柳舒芽呈新貌	两姓结良缘桃花依旧笑春风
举酒贺新婚人共河山并寿	纵情歌盛世春临大地多娇
嘉礼演文明训词与颂词并进	良辰占吉庆琴韵同歌韵和鸣
男女并肩为锦绣江山添异彩	夫妻携手向伟大祖国献青春
此日喜成婚海誓山盟期百岁	今朝劳玉驾谈今论古饮千觞
英才成佳偶杨柳舒新呈美景	良缘联两姓桃花依旧笑春风
小伙子出嫁敲锣打鼓全村相联	大姑娘招亲鸣鞭放炮阖家欢迎
好国好家好夫好妻好日子好了再好	新春新婚新事新办新家庭新而又新
庆佳节佳节会佳期天朗风和天仙配	贺新春新春办新事花好月圆花为媒
春回谐凤律	风静奏鸾箫
桃花开喜色	柳浪荡情歌
柳画眉梢黛	梅添额上妆
花深处鸳鸯并列	枝稀间凤凰共栖
美满夫妻春自永	勤劳门第福常临
春花绣出鸳鸯谱	夜月香斟琥拍杯
银梅香里黄莺啭	玉树荫中紫凤来
春入翠帏花有色	风来绣阁玉生香
晓日芙蓉迎日笑	春风杨柳趁风摇
晓起妆台鸾对舞	春回画栋燕双栖
喜露滋培连理树	春风吹放合欢花
春暖墨融河北纸	夜深人静海南香
春光入院花容艳	喜气盈门人意和
两情于水春作伴	百岁夫妻志相同
春风春雨春常在	喜日喜人喜事多
春风笑引比翼燕	红雨催开并蒂花
春色娇艳容貌心灵皆俊美	喜期澄明欢歌笑语尽开颜
乐事便蕃驾丽凤舞	韶华绮丽燕笑莺歌
雪兆丰年喜气洋洋办喜事	春满门户新风阵阵促新婚
春归雪化果结如意树上	日丽风和花开幸福泉边
一对璧人来彩笔题成鹦鹉赋	几番花信至春风吹引凤凰箫
红妆带绾同心结	碧沼花开并蒂莲
好花宜种留春苑	蜜月同游消夏湾
蓉屏孔雀舞	莲沼鸳鸯歌
采花恰值辰初夏	梦燕欣逢麦报秋
莲花池边成嘉礼	杨柳岸畔咏好逑
倚栏芍药艳	并蒂蔷薇香
雪藕冰桃调玉手	瑶琴锦瑟按金徽
枝头榴花红艳艳	绣帏凤侣情殷殷
才子凌云诗咏雪	榴花映日剑摇风
雪藕素莲调玉手	瑶琴锦瑟按金微
玉楼冰簟鸳鸯枕	宝钿香娥翡翠裙
风送鸾箫声入户	云扶风辇喜临门
鸾凤凌云振玉羽	榴花映日摇轻风
曲奏笙歌迎淑女	筵开凉菜会嘉宾
凤箫声代迎凉曲	金屋人簪避暑犀
朝阳彩凤双双舞	向日红莲朵朵开
玉轸风薰春归夏日	金闺香暖宵短梦长
槐暑近凉听雅乐	兰荫消夏谱新歌
千顷金涛迎喜至	一枝红杏入墙来
槐荫交柯蝉琴谱曲	莲蕾并蒂鸳梦同帏
诗裁纨扇当槐夏	曲度琼箫在麦秋
榴结满枝同心果	莲开一沼并蒂花
弹素月琴奏薰风曲	饮饯春酒题消夏词
户灿三星诗歌束楚	祥征百子图写安榴
栀子结同心喜向帘前唤鹦鹉	莲花开并蒂笑看池畔宿鸳鸯
夏日姻缘红莲出水相映美	良辰情侣雏凤凌空试比高
桂宫蟾耀彩	桐院凤栖身
二美百年好	双星七夕逢
书屏银烛灿	宝镜玉台新
喜看新郎争采桂	欣迎淑女乐留枫
丹枫不减人桃锦	彩笔挥成玉女诗
百合香车迎淑女	中秋朗月照宾朋
喜酒香浮蒲洒绿	榴花艳映佩花红
巧借花容添月色	权将秋夜作春宵
人间好句题红叶	天上良缘系彩绳
桂苑月明金作屋	蓝田日暖玉生烟
月圆花好欢美景	道合志同度良宵
秋色清华迎吉禧	威仪徽美乐陶情
绣幄宵长情馥郁	桂枝香透月团圆
秋满琼京旋折桂	月明银汉听吹箫
秋色淑华吉祥止止	威依徽美乐意陶陶
巧借花容添月色	好将秋夜作春宵
彩凤和鸣梧桐荫茂	关雎雅化苹藻仪修
皓月清光增客兴	中秋佳节乐宾筵
喜日菊香花并蒂	良宵家庆月双圆
银烛高烧月避新妆应怯冷	绛纱好护风摇雅佩不知寒
酒酿黄花，情联驾凤	诗题红叶，梦协能罴
朗月庆长圆光照庭前连理树	卿云何灿烂瑞符天上吉魁星
鸾凤和鸣，秋光满月	雁翔比翼，壮志凌云
嘉会际光明逑好初征双璧合	良辰占吉庆盛仪喜见七香迎
不夜珠明花灿烂	解寒钗暖雪消融
助我三冬文史足	羡君五色笔花新
雁鸣冰未泮	燕乐岁之余
婚筵留客情弥重	腊鼓催人酒不酣
此日花开梅并蒂	今宵人庆月初圆
梅伴冬日雪	喜返意中人
梅雅兰馨称上品	花情月意缔良缘
律叶黄钟听子建	月罗紫府耀长庚
好句联吟初夜月	卺杯醉饮小阳春
得与梅尊作伴侣	从来雪松是英雄
鹦鹉怀中浮竹叶	凤凰琴里奏梅花
评花赋就梅妆颜	咏絮诗成雪满阶
锦瑟声中鸾对舞	玉梅花际凤双飞
梅雅兰馨称上品	雪情月意缔良级
律应黄钟谐凤卜	春回紫帐协熊占
评花赋就梅妆额	咏絮诗成雪满阶
黍谷春回祥开燕春	兰闺宵永梦绕虫飞
雪案联吟诗有味	冬窗伴读笔生香
雪点香车依是玉	星回茆屋宛然金
锦里枫丹芳联奕叶	华堂藻耀瑞霭琼英
红梅开并蒂	喜烛照双花
梅试香月腾骥足	月星瑞色映芳樽
白雪无尘爱情圣洁	红梅有信盟誓坚贞
梅花芳讯先春试	柳絮吟怀小雪初
英俊儿男风云际会	窈窕淑女冰雪聪明
雪里梅花门前结彩	风中柳絮房内呈祥
合卺交杯洞房花烛三冬暖	并肩携手举世芳名四化香
两姓良缘天作好合	三冬美景雪融清香
梅花隔岁开早夸才子凌云笔	柳絮因风起曾记佳人咏雪诗
雪笺题吟朱陈结好	梅边索句秦晋联姻
大地雪花飘诸客飞觞酣马战	高林梅萼放季男受室慰龙钟
白雪无尘如爱情圣洁	红梅有信似美好心灵
岁序值黄猪兆卜鸾飞偕凤舞	怀觞倾绿蚁喜开蜗室款鸿宾
佳节佳期佳境葱茏舞鸾凤	新人新事新风浩荡振家邦
已睹春云笼彩鬓	还窥夜月映金莲
良辰占尽无双福	新岁初一第一筵
新婚吉庆日	大喜艳阳春
天上四时春作首	人间百事婚当先
春临大地迎新岁	春到人间贺佳期
元旦行嘉礼	新年结良缘
佳节良宵行佳礼	新年美景庆新婚
一元复始祯喜庆	万象更新瑞福祥
月圆花好欢今夕	道合志同贺盛年
春正快睹三阳泰	首岁欣看长子婚
人喜家欣天下喜	山欢水笑神州欢
伉俪并鸿光竞美	生活与岁序更新
桃符新换迎春怡	椒酒还斟合卺杯
风纪书元门庭有喜	鸡声告旦夫妇同心
淡白梨花堪人脸	娇红桃粉可凝腮
银烛光浮元夜月	紫箫吹彻玉堂春
才贴桃符梅王艳	又迎鸾凤喜添翎
风暖丹椒青鸾起舞	日融翠柏彩凤来翔
元旦佳节成吉日	新婚妙龄结良缘
一代桃符宜春共写	万家柏酒合卺同斟
乐新春丰年迎喜	庆吉日盛世联姻
嘉礼欣逢元旦节	新婚喜放自由花
吉语饼蕃祥征彩胜	韶华燕喜辉映春灯
人对艳妆饶艳福	樽倾春酒醉春光
彩灯照洞房新年共饮交心酒	华筵款嘉客宾主同端贺喜杯
佳节娶佳人频传佳话	新年更新貌同谱新篇
庆佳节佳节会佳期天朗星明天仙配	贺新春新春办新事花香月洁花为媒
鸟弄芳圃传韵巧	花明丽月映娇姿
同心同步百年路	双手共描二月春
春暖花香鸟语	夫英妻俊家欢
银灯光摇金缕紫	玉楼人映杏花红
景值仲春联双美	婚结两姓合一心
一对璧人开吉席	二分春色到华堂
二分春色九霄月	一对新人百载情
仲阳绿柳飞鹦鹉	花月新风迎凤凰
鸟弄芳园传巧韵	花明丽月映娇姿
红杏枝头春意闹	彩门楼下玉箫清
燕把春泥筑宝垒	莺穿杨柳织翠丝
苑内桃花开并蒂	檐前燕子习双飞
鹈鹕鸟唤春当仲	比目鱼游水正温
柳絮新词传绣阁	杏花春色丽妆台
并翅金莺初织柳	双飞紫燕未衔泥
姻缘缔结三生久	旖旎平分一半春
云拥妆台和风正暖	花迎宝扇丽日初长
妆阁红腮桃艳艳	镜台绿鬓柳丝丝
夫妇缔姻缘二月结婚花竞放	宾朋同祝贺百年偕老月长圆
前程辉煌同事同心同喜	春光明媚新人新岁新婚
凤翔鸾鸣春正丽	莺歌燕舞日初长
嘉宾戾止苹风暖	之子于归杏雨浓
桃李香三月	姻缘庆百年
名花艳映同心侣	美酒春留婪尾杯
门逢新禧月方满	花到韶春香正浓
乐和笙箫吹夜月	花开桃李笑春风
三春桃花红锦绣	万盏银烛引玉人
翠柳巧妆鸾凤侣	红桃宜挂丽人头
灼灼桃花遥映面	弯弯柳叶远归眉
万紫千红十分春色	双声叠韵一曲新歌
荷钱掩映楼头月	燕翦差池槛外风
烟开柳叶香风起	春人桃花暖气匀
天郎气清三星在户	琴耽瑟好百辆盈门
景丽三春天台桃核	祥开百世金谷花桥
紫箫吹彻燕桥月	翠鸟翔还彩屋春
桃丽三春璇闺日暖	景开百世金谷花娇
三月桃花争春色	一声爆竹引玉人
嘉宾饮多杯莫负他红杏撩人绿杨戏马	新婿逢三月宛如那黄莺作对粉蝶成双
采莲词调更新曲	咏絮才华写人诗
绕屋扶疏杯映绿	照人欢爱独摇红
蔷薇香绕屋	芍药喜拥门
清明盛世应佳日	恩爱夫妻共韶华
采莲词调更新谱	咏絮才华写入诗
美满姻缘天作合	清明时节日初长
牡丹香里人如玉	喜字门前笑绽花
探花幸际辰初夏	梦燕欣逢麦至秋
榴火烧天符系赤	荔云笼院叶题红
首夏为翁难设宴	麦秋醮子喜成家
满架蔷薇香凝绮阁	倚阑芍药艳映琼楼
林鸟声声催布谷	席宾码码兴猜拳
且喜种田添助手	更欣中馈得佳人
满架蔷薇香浮白酒	沿街芍药放拥红妆
月应瑞萱增一叶	丝添长缕结同心
麦浪芳菲莺花共艳	桃潭稼郁鱼水同欢
玉轸风薰琴声和畅	金闺日永花气细缦
青草池塘歌声两部	黄梅时节比翼双飞
儿媳好姻缘四月结婚荷衬绿	宾朋同祝贺百年佳侣叶题红
妆匣尚留金翡翠	麝香数度绣芙蓉
绣阁烛映鸳鸯立	花坛影偕蝴蝶飞
绿竹恩爱意	榴花新人情
卺酒香浮蒲酒绿	榴花艳映烛花红
佳期临近端阳节	乐园长开吉利花
榴天映碧水	蝶舞乘东风
月满槐厅人意好	江深草阁客人单
薄酒泠春迎淑女	榴花影日宴嘉宾
榴花添爱意	仲夏暖衷情
抬头欣见金莺舞	侧耳喜听彩凤鸣
云开兰叶香风起	火灿榴花暖意融
五月石榴红似火	同心夫妇贵如金
爱情因劳动溢美	智慧靠勤奋闪光
五星旗下青春健	一德诗中情谊长
五世共昌歌燕尔	一双恩爱乐新婚
只因菡萏连枝发	惹得鸳鸯比翼游
榴花似火灼杲日	香蒲如云迎丽人
劳动节迎来劳动女	幸福天常光幸福家
才子凌云佳人咏月	榴花映日浦叶摇风
艾绶舒风榴花耀火	鸣鸾歌日彩凤翔云
夫妻似胶漆恩恩爱爱	光景如榴花火火红红
劳有所获一勤天下无难事	动之以情二南句中有作为
喜酒醉榴花面容未似榴红杯莫放	爱情舒柳眼妇眉欲如柳细笔轻描
沼上莲花舒并蒂	庭中荔子缀连枝
调羹新遣细君肉	雪藕同调公子冰
荷塘新蕊放	月色慧心圆
莲沼鸳鸯歌福绿	蓉屏孔雀绚文章
梧桐枝上栖双凤	菡萏花间立并鸳
乐奏林钟偕凤侣	诗歌南国叶螽斯
柳叶眉添金兆笔	藕丝纱罩美人裳
已向蓝田收白璧	还于绣幕引红绳
新花瑞色浮妆阁	早稻薰风入洞房
荷叶池中鱼比目	蓝桥石畔凤双飞
鸾凤新声早秋叶律	鸳鸯好梦盛暑弥酣
莲渚风清迎淑女	梅庭月朗宴嘉宾
六月红莲双蒂艳	堂兄好友共交杯
鸾凤和鸣莲花并蒂	麒麟瑞叶玉树连根
弹琴咏诗且以喜乐	浮瓜沈李大好时光
槐荫连枝百年启瑞	荷开并蒂五世征祥
翠竹碧梧丽色映屏间孔雀	绿槐新柳欢声谐叶底新蝉
蓝桥恩爱重	瓜节谊缘长
凤冠逢人间七月	鹊桥渡天上双星
欢声偕鱼水	喜气溢门庭
九华灯映照金帐	七孔针穿彩缕丝
爱情花并蒂	比翼鸟双飞
燕子慢疑钗是玉	仙郎应悟鹊为桥
红妆带绾同心结	碧叶花开并蒂莲
银汉双星金秋七月	人间巧节天上佳期
银汉一泓看鹊渡	金风万里待鹏飞
新秋吉日迎淑女	巧节佳期贺新郎
月照碧梧双凤影	凤吹绿柳偶莺鸣
新秋金阁成佳偶	瓜月婚期结良缘
两朵红莲开并蒂	一生忠贞结同心
路人桃源花灿烂	桥横银汉水涟漪
银流双星金秋吉日	人间七巧天上佳期
稻熟麦香丰收张嘉宾	秋高气爽欢乐迎新亲
试问夜如何？牛女双星缠碧汉	欲知春几许？凤凰比翼下秦台
阳洧阴长夏去秋来把酒谈心歌泄泄	海誓山盟珠联璧合良辰卜凤咏关关
月掩芙蓉帐	香添锦绣帏
中天一轮满	秋日两姓欢
喜望金菊放	名誉新人来
吉日恰逢桂子熟	新婚喜共月儿圆
今夕月圆花正好	明朝道合志长同
世盛业更盛	月圆人亦圆
新婚喜遇中秋节	丹桂偏钟稻谷香
花容羞月色	秋夜作春宵
兰室夜深人旖旎	桂轮香满月团圆
皓月清光添喜气	中秋佳节庆新婚
才子佳人词填月谱	人间天上曲奏霓裳
豆蔻清香传合卺	芙蓉丽色映新妆
十色缀地花香久	五光映天恩爱长
月下花前十分美满	人间天上一样团圆
金风已渡黄金屋	玉露还滋白玉田
贵礼欣逢中秋节	合欢喜在月圆时
玉律鸣秋鹊桥路近	金风涤暑鱼水欢谐
云楼欲上攀丹桂	月殿先登晤素娥
婚时月圆心更满	饮当桂馥兴龙浓
丹桂香飘姻联两姓	蟾宫月满喜照人间
妆阁试呈双凤舞	蟾宫先折一枝香
秋色清华吉祥逸逸	威仪徽美乐意陶陶
金屋光辉花正好	玉楼宵静月赏圆
志同道合金菊吐艳	花好月圆丹桂飘香
佳节好春光鸟语花香奏佳乐	中秋缔良缘月圆人寿谱新曲
花好月圆，祝家家幸福	婚姻两愿，喜代代风流
银河双星任石烂海枯同心永结	人间佳节共天高地阔比翼齐飞
黄菊绽金光云髻	芙蓉含露醉朱颜
完婚喜值三秋候	合卺欣逢九月天
摘花迎淑女	采菊赏佳宾
送酒刚送开径后	调羹时值授衣时
萸囊色映齐眉案	菊圃香传合卺杯
九朵秋花簪凤髻	一弯新月画蛾眉
笑把黄花轻插凤	间拈黛笔淡描蛾
酿熟黄华节逢重九	眉分碧月样画初三
红叶染成诗作伐	黄花酿出酒盈樽
士君子爱敬堂怀	莫把新婚移少慕
气爽秋高金菊吐艳	月圆花好丹桂流金
不劳鸿雁传尺素	且喜秋声入洞房
彩笔生花书成锦宇	新诗撷艳体合香奁
彩笺吟就新诗好	红袖擎来菊酒香
堂上瑟琴看并蒂	天边鸿雁听和鸣
凤髻黄花添秀色	蛾眉斑管画新妆
国庆佳节成佳偶	福祥良辰结良缘
池生秋月竹叶秀	帘映英姿笑声喧
造凤雄雀化	明月凤凰飞
百族万方歌国庆	一门二秀唱家祥
同心盟证三生石	连理枝开十月花
小春迎雅客	阳月惠佳人
十里凯歌传吉庆	一堂鸿喜染祥棋
画蛾自见银钩灿	簪凤犹闻玉骨春
十分美好日	一往深情时
喜酒饮来三日醉	早梅分得一枝春
风和日丽金十月	夫唱妇随乐百年
十月金风入金屋	一双佳偶逢佳期
翡翠帘垂初夜月	芙蓉镜映小阳春
十月美景常在目	两情佳期早归心
十里笙箫迎淑女	一番锣鼓贺新郎
花放芙蓉春尚小	酒斟琥珀夜初长
几度新诗题红叶	十分恩爱到白头
家国同迎喜庆日	夫妻共唱幸福歌
大雁乘风飞玉宇	夫妻比翼乐阳春
红锦裁云紫箫吹月	翠屏引凤彩帐栖鸾
婚庆喜逢国庆节	桂花偏惹菊花香
点额新妆春探梅岭	同心嘉偶喜溢兰闺
梅花芳讯先春试	柏叶吟怀小雪初
两姓良缘天作合	三冬好景月初圆
十里山河处处莺莺燕燕	一园春色朝朝我我卿卿
十里梅花香共吟陆游佳句	一天瑞色美同驾宗悫长风
小子结良缘恰当点额新梅刚逢十月	嘉宾开雅量正好猜拳放马畅饮三杯
雪案初吟才女絮	玉盆新供水仙花
凤振双飞翼	梅开并蒂花
皓月措来双影雁	寒霜映出并豆梅
灰飞薛管声谐凤	玉种蓝田兆梦熊
雪飘双飞蝶	灯映并头梅
紫鸾对舞菱花镜	海燕双栖玳瑁梁
凤琯吹成三弄曲	熊占吉叶一阳生
黄钟鸣爱律	红叶题诗情
不虑严霜帏外妒	应怜美玉帐中香
霜染竹叶藏青缕	露滴梅花点黛眉
宫线新添同命缕	绣帏初放合欢花
雪雁双飞畅月景	红梅并放香冬妆
麟趾呈祥一阳初复	螽斯衍庆五世其昌
矫燕双飞偶偕老	雪花六出梅吐香
翠柏苍松盈喜气	银花玉树映新人
青松枝头白鹤为偶	紫竹园里翠鸟成双
冬至阳春冰欲沣	天寒炉暖酒尤香
交柯松树傲腊霜	并蒂梅花报新春
腊月梅花勿让雪	新春玉步待迎人
雪伴红梅放	门迎淑女来
风琯排成星十二	峨眉画就月初三
筮近新年丝牵翠幕	缔成佳偶玉种蓝田
腊粥试调新妇手	春酷初熟阖家欢
阖家欢庆腊月禧	并蒂盛开一枝梅
咏雪才高欣谐绣口	凌云华妙雅擅画眉
翠黛画眉才子笔	红梅点额美人妆
良缘一世花开艳	美景三冬月更圆
箫引凤凰春生斑管	杯斟鹦鹉香溢梅花
吉日红花梅并开	良宵家庆月双圆
旧岁将辞且趁吉时行吉礼	新年即届迎来春始探春人
腊月将尽喜趁吉日行吉礼	瑞年即临迎来新春接新人
大喜本呈合院瑞	繁枝偏缀趁花妍
润物悄然多夜雨	月朗惹静有清箫
润泽赖甘霖洒露有情三季艳	月筛窥静夜探窗每冗心两浓
好事有缘多一庆	瑞花着意著双枝
盟书早订三生石	彩笔新开五色花
河鸠声里饶诗意	花笔窗前好画眉
育李育桃夫妻乐洒两身汗	为家为国园丁喜伴一盏灯
灯下畅叙夫妻爱	洞房尽飘桃李香
同培桃李恩爱夫妻情意重	共献青春热衷教育幸福长
爱情如几何曲线	幸福似小数循环
天台路近逢仙子	科海波平渡鹊桥
并肩奋进长征路	携手攀登科技峰
并肩奔四化	携手登九天
同心果满千秋树	比翼鸟飞四化程
爱情因事业增美	成就靠知识闪光
志于云上得	人自月中来
日月合璧映出光明世界	伴侣同心迎来美好家庭
协力同心巧织九洲锦	并肩携手精描四化图
松竹梅兰同相爱	琴棋书画共抒情
得意唱随山水外	钟情拓入画图中
女慧男才原是对	你恩我爱总相联
英男慧女结佳偶	玉管金弦赞独生
诗歌南国好逑句	书赋东莱博议篇
改革诗文描大地	新婚歌舞庆良辰
百尺竿头齐比翼	千般情谊共登科
体坛同获锦	婚礼共开樽
宜国宜家新伴侣	能文能武好英才
武术有源千流一脉	婚姻守信百年同春
午夜鸡鸣欣起舞	百年虎啸勇攀登
运动场并肩竞赛两遂志愿	家庭里携手同行一往深情
一双爱侣乐为祖国添光彩	两颗红心争替体坛夺锦标
春暖杏林花并蒂	日照兰阁燕双飞
愿期天下人长健	何吝洞房夜永甜
橘井龙吟月	杏林凤唱春
乐为病人尝百草	喜与情侣话三更
今夕交杯传蜜意	来朝出诊送温馨
妙手回春传趣话	青梅竹马结良缘
婚尚文明喜溢华堂双合璧	术称精湛乐汲橘井万家春
治国齐家和衷共济	杏林花好之子于归
喜看洞房贤淑玉	争羡政界德才人
箫歌竞赛霓裳曲	淑女相偕掌权人
创业成知己	属职结良缘
千秋大业结良缘	四化新人比翼飞
千秋大业挥双手	四有新人结同心
且欣绣幕联双壁	但愿春风溥万家
箫引凤凰听雅乐	鼓催政绩谱新声
立志同挑革命担	同心共写振兴诗
众仙竞奏霓裳曲	淑女争看象服宜
香梅融雪扬正气	淑女伴郎治清风
美女才子天成佳偶	洞房花烛月庆团圆
堂上鸣琴留政绩	房中鼓瑟缔良缘
以国为怀喜连理	成家立业永同心
缔结姻级相亲相爱	振兴祖国同德同心
两袖清风办喜事	一身正气宴宾朋
贴心伴侣共创千秋业	同志夫妻齐做四有人
男女合栽连理树同心同德亦同志	夫妻共育一枝花利国利民又利家
手开翠岭双锄落	眉剪青山比翼齐
相爱喜逢同读伴	结缘恰是共耕人
久勤耕作事农圃	新有室家长子孙
良缘喜结同心谱	春光永驻五好家
勤劳致富宜同勉	和顺理家贵相帮
四境谐良风俗美	百年庆佳偶天成
佳偶同偕百年老	好花共育一枝红
琴瑟水调月圆花好	家风不改女织男耕
尽孝事亲天宜降众	饷耕有妇喜听鸣鸠
自谈自恋不收彩礼新风尚	结爱结亲注重情缘共旅程
喜今日务农能手结情侣	看来年致富金花焕彩霞
长征奋展双鹏翼	四化昂扬万里心
经营春夏秋冬货	喜惠东南西北人
合作制成新作品	勤工斯见好功夫
商界有名精货殖	姻缘守义尚新风
经营有道金为信	恋爱无瑕贵守诚
璋瓦伫看新制造	羹汤初试好调停
三尺柜台情结伴	一腔热血惠来人
秦晋百年新结好	婚姻四美共遵行
文明模范春难老	建设标兵志永恒
事业成功商界内	爱情美满家庭中
经营有助添中馈	缔结良缘裕后昆
生财预卜前程远	握算还须内助贤
商店承欢联二美	洞房充喜耀三星
梅花应笑异姓侣	瑞木新成同心缘
起家勤俭添中馈	宜室贤能配合欢
光荣榜上争模范	幸福家中做夫妻
喜气萦回双美合	爱情贞洁百年长
商界有名精华殖	吴门偕隐似神仙
经商得法添中馈	宜室贤能融合欢
汇集蝇头行元礼	独亏雀舌宴三亲
同心织出鸳鸯锦	妙手染成幸福花
商店今喜添春色	洞房相宜增德辉
女忒英贤誉盈巾帼	郎诚杰俊业务陶朱
三尺柜台新伴侣	百年光景好夫妻
纯结爱情千梭织	青春伴侣一线牵
店铺腾欢，利增百倍	门庭有喜，福享百年
入户三星辉增天市	盈门百辆喜溢华堂
事业兴隆甘流千滴汗水	爱情甜蜜奉献一片丹心
男女平权分工合作	室家和乐迪吉凝休
军号声和房中乐	情歌薰调帐外风
军民同谱凯旋曲	夫妇共浇恩爱花
大道并肩携手	军营易俗移风
日暖军营春试射	风和礼室夜开樽
荣耀门庭添凤彩	英雄战士喜鸾鸣
梦虎联姻曾射虎	屠龙有技好乘龙
军营月色黄金缕	新屋花香碧玉箫
鸿案相庄鸡鸣戒旦	凤占叶吉虎帐生春
军营栽下连理树	蜜月绽开合欢花
军民同谱凯旋曲	夫妇共浇恩爱花
好男儿立志当英雄	新妇女决心做模范
两颗红心相映美	一对情侣笑联姻
帷房曲奏军中乐	军帐盟成石上缘
威武将军风云除令	窈窕淑女冰雪聪明
钢铁长城千里因	丝罗佳偶百年春
十五月明连理树	万千灯照合欢花
营柳风清巢栖鸟鹊	井梧月朗枝集凤凰
战地月圆看比翼	洞房花好结同心
睹面霞光胜宝盖	画眉春色上征衫
占凤协祥有情眷属	闻鸡起舞尚武精神
边关受奖喜配百年偶	伟业立功精描四化图
并蒂红花盛开军营路上	振翮俊鸟比翼生活途中
朗朗将星银河驾鹊	洋洋军乐彩辇迎鸾
燕侣双栖何妨作客	蟾圆全美可免思乡
家乡阻隔云千里	客邸团圆月一轮
三星在户百辆盈门	琴瑟在御凤凰于飞
弹琴咏风宜其家室	承欢侍膳贻厥子孙
一索得男占取妇	大邦有子咏宜家
翁上为翁翁不老	妇前称妇妇皆贤
饴座承欢兰荪茁秀	卺杯叶吉瓜瓞赓绵
序列三阶孙娶妇	样开四叶子为翁
名流喜得名门婿	才女欣逢才子家
宝马迎来云外客	香车送出月中仙
桃面喜陪嫁	梅香和衬妆
嫁女喜逢大好日	送亲正遇幸福年
入院勿丢慈母训	出闺宜守我家风
于归好咏宜家句	往送高歌必戒章
此去婆家应俭朴	当思慈母久劬劳
养女已传针线术	适人再授桑麻经
玉镜能谐温峤志	荆钗甘为伯鸾容
应要睦邻和妯娌	更须敬老奉翁姑
此去夫家宜俭谨	莫忘兹母久劬劳
嫁女喜逢良好日	送亲正遇吉祥年
书卷为奁宜爱女	清茶当酒谢亲朋
日丽风和门庭有喜	琴耽瑟好金玉其相
有缘过门聚白首	同步偕婿结青鸾
女因亲老赡养终生难容辞	婿尽子职情通四海理不亏
此去有家切记克勤克俭	再来无议才算乃贤乃良
红颜今日自有琴棋助雅兴	白发他年还求书画伴遐思
联谊联亲何必门当户对	择婿嫁女只求道合志同
无物添奁诗书笔砚随身带	有言嘱女俭朴勤劳致力行
无物可陪五讲四美随身带	有言相嘱百好一勤致力行
喜溢重闺瞻祖竹	乐居老屋附孙枝
愧无玉具陪孙嫁	却有良言赠晚闺
瑟鼓房中凫翔静好	箫吹楼上凤律归昌
喜见凤雏亲老凤	笑看枝杈育孙枝
风律归昌克绳其祖	雀屏获选附列于孙
绣阁春风催嫁杏	香闺喜兆报征兰
赠嫁当夸钟进士	联吟不让鲍参军
家人易卜占归妹	君子诗词咏好逑
聊陪诗笺东坡礼	暗助少游西月联
作赋擅清才压妆定有香茗笺	于归偕妙偶宜室合咏敬老诗
虽分伯仲两家灶	胜似爹娘一样亲
车轮鸟翼联同体	伯爱叔思脉一源
满堂溢彩嫁犹女	香奁添妆送新娘
柳絮擅清名也应犹子比儿相攸喜中雀屏选	棣华敦雅谊最是于归所得孔怀不负鸰原心
淑女迎夫除旧俗	美男落户树新风
大开贰室为甥馆	略设粗肴作客筵
得赘贤郎即是子	生来好女胜于男
贤婿作儿福中福	爱女为媳亲上亲
好女娶夫破旧俗	英男落户树新风
凤求凰往时佳话	男嫁女今日新风
欣看晋殿乘龙婿	喜听秦楼引凤箫
借说秦楼偕弄玉	今知甥馆是箫郎
结彩张灯迎贵婿	开筵举祝宴嘉宾
他山之石可攻玉	就地栽花勉动根
腹袒东床歌琴瑟	樽开北海宴友朋
秦楼引凤传佳话	鲁酒邀宾任健谈
袒腹床东歌荇藻	承颜堂北拜椿萱
自古都云凤依凤	于今却尚凤求凤
扫净巷门迎戚友	粉刷茅屋迓箫郎
梧桐滴翠，欣闻引凤去	丹桂飘香，喜见乘龙来
婿是儿，儿是婿，两全齐美	媳当女，女当媳，亲上加亲
东吴曾此招亲女婚男嫁	西阁于今开户花好月圆
吉日良辰，欣逢佳节迎佳婿	男到女家，喜办新事树新风
男尊女女尊男，男女平等	夫敬妇妇敬夫，夫妇相亲
东吴曾此招亲，女婚男嫁	两厢只今开户，花好月圆
骄客不劳箫史凤	佳人即是女元龙
声送玉箫来引凤	影摇银烛照乘龙
改嫁有勇破旧俗	续弦无妨建新家
人间甚爱月轮满	梁上欣欢对燕亲
千里姻缘一夕会	半生结偶百年亲
海燕引雏朝凤阙	江鱼带子跃龙门
鸾胶今日续驾交依旧是名门淑女	凤小将来扬凤彩还须应丹穴佳雏
苑上梅花欲再度	房中琴韵自重调
桃花苑里花仍灼	柳放江头絮又新
温峤良缘窥玉镜	庐陵佳偶续金弦
堂前乍见浑如昨	帐里回思恍似新
珠帘月影重辉夜	锦阁花香又度春
再续姻缘春溢丽	重调琴瑟韵尤谐
前情幽然都如梦	后景红艳胜似春
黛眉青山春不老	香添绣阁月重圆
梅开二度花复艳	月缺重圆光尤明
琴瑟重弹前情尽释都如水	姻缘再续来日方长总是春
旧情重好同心协力献余热	鹊桥再架并肩携手度晚年
夜复同眠从此夫妻合更好	桥重再架自今恩爱结尤牢
烛照洞房缺月依旧成满月	名登金榜故人而今做新人
花月新妆宜画柳	同窗好友巧栽兰
相爱常忆同桌事	结婚总怀依旧情
花好月圆昔日曾共砚	志同道合今宵庆合欢
同校同行同侣	知人知面知心
常忆窗前吟妙句	好谈学友传趣闻
碧沼红莲开并蒂	云窗学友结同心
我爱你同窗共读高中课	你恋我齐心同进大学门
昔日同窗青梅竹马谈理想	今宵合卺高山流水话知音
九蜿兰香花并蒂	千年梧碧凤双栖
男男女女恩恩爱爱	对对双双喜喜欢欢
双双蝴蝶随风舞	对对鸳鸯戏水游
对对红莲齐开碧	双双彩蝶共舞春
水好儿男破千年旧俗	风贤淑女开一代新风
簇簇春花映千家春景	对对新侣开一代新风
同心同德为同一目标结成同伙伴	新郎新娘在新的时代谱写新篇章
同奏鸾笙分画阁	双排燕翼到天台
窗前各叙柔情暖	堂上共草长辈亲
序列雁行郊郊媲美	迎同凤辇钟郝齐辉
伯仲阶前分姊妹	弟兄花下各东西
同胞今日齐成礼	妯娌此时共相亲
如足如手如宾如友	大宋小宋大乔小乔
嫁女娶媳喜盈门庭不多不少	送往迎来春满大地皆福皆祥
兄婚妹嫁同日同禧	男娶女娉皆佳皆欢
喜一家兄妹同日各成佳偶	祝两对夫妻协力共描宏图
喜喜喜嫁妹适逢祥庆日	新新新娶妻正遇德嘉时
同庚男女同时代	一对夫妻一颗心
同龄巧结同心偶	并世喜开并蒂莲
双林飞出同龄鸟	异姓结成百岁缘
同岁男交同岁伴	有才女配有才郎
互励互学齐上进	相亲相爱共争荣
同学加同志	同伴又同行
诚托肝胆同谋事	乐酬寒窗共枕盟
同行同心相促进	新事新办不铺张
同姓英男交淑女	一心凤侣结鸾俦
缔佳偶原为一姓	结良缘更得同心
同姓巧遂同道侣	并肩喜结并头梅
心存赤志本同德早已相爱	姓有源流分百派原不近亲
父婚衬映儿婚喜	雏凤相偕老凤欣
红梅吐秀绽新蕊	老树迎春发绿枝
少是夫妻老是伴	新来媳妇乍来婆
未经十月怀胎苦	却有千声叫娘亲
寿辰联璧双重喜	菽水承欢百世昌
父寿儿婚双庆度	婆欣媳娶满庭馨
当谢高朋来贺寿	更欣愚子既完婚
吉期欢娶红颜女	合卺倍思白发亲
权展喜容迎客友	强开笑脸闹花烛
完婚恨晚亲无在	开宴未退客复来
丧后款嘉宾仍旧笑容满面	吉期迎淑女依然喜气盈门
燕过喜门留好语	莺迁乔木报佳音
此日新居迎巧妇	他年瑞气伴卿云
新屋落成迎大喜	花堂设筵接鸿宾
篷门换旧迎佳女	陋室更新作洞房
早已钟情同邻里	不须恋爱共知心
双喜相映喜上喜	对门联姻门冲门
恋爱隔墙不隔意	新婚同屋更同心
两姓结成百年偶	对门吉庆双喜婚
青梅竹马男偕女	户对门连妇嫁夫
互帮互助好邻里	相爱相亲美鸳鸯
妻大良缘天作合	夫小吉辰海誓盟
良缘自有媳妇大	恩爱何不丈夫小
天意作媒牛郎小弟多英才	恩爱为基织女大姐更德贤
正喜老龙胜锦浪	更看新凤集琼枝
晚年成美事	老骥结良缘
暮日欣交贴心伴	余生乐度幸福秋
红线牵来新伴侣	鹊桥搭就老夫妻
晚年喜成形影伴	夕阳乐与晚霞红
欢度晚年成佳偶	发挥余热立新功
老年缔结良缘好好好	晚辈玉成美事佳佳佳
夕阳无限光景美	萱草有根晚花香
新知长相知知心知意知冷暖	老伴永作伴伴读伴游伴春秋
夫妻恩爱成几何直线	儿孙万孙似小数循环
恋爱自由无三角	人生幸福有几何
亚非欧美风云尽收眼底	中外古今大事罗列心头
大圆小圆同心圆心心相印	阴电阳电异性电性性相吸
红颜今日自有琴胡助雅兴	白发他年还待书画伴遐思
俊秀女郎三八模范	雄奇男儿五一标兵
红线常牵来妹妹情意好	裁尺准量出哥哥恩爱深
燕莺穿柳矿山舞	鹊鸟搭桥煤海歌
松竹梅兰同相爱	书画江山更风流
芙蓉牡丹皆是花中矫子	启明长庚尽为星里美郎
初见钟情今作伴	一堂大喜始膺门
初婚情侣成佳偶	一对妙龄结玉缘
初夜入宵成美事	二人惬意度良辰
初衷结玉盟金鸾争翥	二姓成连理骏马齐奔
初月筛银光诗题红叶同心句	三更絮蜜语酒饮黄花合卺杯
初韵喜调恩爱调	三星欣遇共明时
初季花鲜人似玉	四时情厚贵如金
初夜话前情共忆山盟海誓	四更圆旧梦同传蜜语良言
初月高悬玉蟾腾大地	五星普照喜鹊聚银河
初月高悬辉栋宇	五音协奏弄情歌
初葩并蒂新婚美满	六术交柯绿叶葱茏
初阳聚福光凤飞万里	六合连祯瑞琴奏百年
初阳增彩并肩共绘新图画	七政启辉比翼齐飞碧宇天
初衷情重称梁祝	七巧婚联架鹊桥
初识便许情结合多称如意事	八字无关命工夫不负有心人
初婚喜结称心侣	八面欣传祝福歌
初见妙龄同气结	九畹金菊并蒂开
初恋喜遂完玉璧	九歌乐奏颂尧天
初愿遂心琴瑟同奏幸福曲	十分惬意夫妻共描锦宏图
初会合卺成知己	十分得意伴终身
十里笠歌迎淑女	一家喜气树新风
十里桂花香共诵陆游佳句	一天清气美同歌李白长风
十风五雨天爱情树结丰收果	二姓相亲结连理枝开幸福花
十全其美恩情侣	二燕齐飞碧宇春
十锦妆成箫引凤	三阳开泰喜乘龙
十万山河添异彩	三千珠履贺新婚
十里梅兰香同心事业换新貌	四时松竹翠满目山河改旧颜
十面风吹联蒂蕊	四方乐奏向心婚
十光缀地花香久	五色映天恩爱长
十雨春光隆化育	五风香辇映红妆
十全结玉缘预期幸福	六出天晴雪兆庆丰年
十雨及时荣草木	六花献瑞赋青春
十分春意妆银面	七彩霓虹架玉门
十里云霞美喜看长空比翼	七弦琴瑟和欢谈大业同心
十香车拥门生彩	八骏马驰凤嫁龙
十亿心齐共创千秋大业	八方乐奏喜歌两姓良缘
十雨五风再睹唐虞盛世	九州四海同欢幸福家园
十里好花迎玉女	九台芳草贺英男
二情恩爱乐冬夏	十里馥馨延韶华
二姓联姻正喜梅兰竞艳	十分遂意同调琴瑟和声
二情恩爱同心结	一院雍和百世昌
二扇彩门飞彩凤	一双红烛映红心
二秀成婚逢盛世	双鸥飞舞结良缘
二英相爱结佳偶	两姓同心展大猷
二姓良缘千缕情丝春永驻	三更蜜语百般恩爱树常青
二喜临门幸福至	三星在户新人来
二情鱼水许同爱	四化蓝图待共描
二杯合卺酒男欢女喜	四化同心歌国治家齐
二人好合新成伉俪	五世其昌妙结姻缘
二心相印抒高志	五乐齐鸣庆大婚
二分明月照门户	六合同春缔玉缘
二骏同奔创大业	大合共仰绘宏图
二情好合喜听琴奏和谐曲	七政增辉欣看凤飞吉瑞天
二星合彩耀家室	七巧同心守工盟
二姓情人成眷属	八方亲友贺新婚
二妙钟情心似铁	八方呈秀月常圆
二分明月光照一双倩影	九殿仙媛袖舒万里长空
两朵红花争怒放	九霄俊鸟比高飞
三三竹叶同联九有	十十梅花共结百年
三冬瑞雪恰似纯诚情爱	十里春风竞催勃发生机
三山五岳争呈彩	一统九州喜到门
三冬喜气生璧玉	一帘明月照佳人
佳节娶佳人频传佳话	新年更新貌同谱新篇
一元复始祯嘉庆	万象更新瑞福祥
人喜家欣天下喜	山欢水笑神州欢
彩灯照洞房新年共欢交心酒	华筵款嘉客宾主同端贺喜杯
新岁新婚新起点	喜人喜事喜开端
爆竹声中辞旧岁	华灯影下看新人
华灯映照芙蓉帐	红联叠缀洞房春
喜爆鸣喜新郎乐点朝天响	新饺孕新善妇巧包敬老欢
劳动节迎来劳动女	幸福天常光幸福家
五律高鸣歌道喜	一堂大庆雁来朝
五星旗下青春健	一德诗十情谊长
劳有所获一勤天下无难事	动之以情二南句中有作为
新婚喜遇中秋节	丹桂偏钟稻谷香
今夕月圆花正好	明朝道合志长同
吉日恰逢丹桂硕	新婚喜庆月儿圆
瑶琴一曲双声奏	月殿三秋五桂香
百族万姓歌国庆	一门二秀唱家祥
新婚幸共国同庆	金菊香同家获麟
十里凯歌传吉庆	一堂鸿喜染祥祺
五星旗展映红日	双鹊声高染庆云
白头偕老	同心永结
屏中金孔雀	枕上玉鸳鸯
才高参天松	人佳凤凰楼
月朗银河渡	烛光绣阁香
金凤和绣帏	玉堂梅似雪
洞房乾坤真浩大	金屋春浓花馥郁
雨情鱼水春作伴	金鹏共奋理想翅
翠帐月如钩	明月悬洞房
琼楼夜永月团圆	屋内夫妻水调合
彩凤双飞锦绣程	百年恩爱花长红
花间金作屋	灯下玉为人
柳色映眉妆镜晓	桃花润面洞房春
交杯勿坠青云志	蜜月应有立业心
爱浸心灵高格调	情钟眉宇不俗容
花烛银灯鸾对舞	春归画栋燕双飞
咫尺姻缘歌巧合	百年好遇祝良缘
轻画黛眉欣此日	同骑竹马忆当年
兰引香风归绿幔	燕寻佳梦到金闺
金屋交杯浮美酒	玉堂燃烛灿琼花
锦琴声中鸾对舞	玉梅花际凤双飞
情深互助互勉励	爱在相亲相敬间
荷开并蒂引燕贺	芍结双花肇宏图
良缘一世同地久	佳偶百年共天长
花开并蒂鸳鸯暖	酒醉同心琥珀浓
芝兰同介百年春	琴瑟永谐千岁乐
鸳鸯夜月铺金帐	孔雀春风软玉屏
花深处鸳鸯并列	枝稀间凤凰共栖
眉黛春生杨柳绿	玉楼人映杏花红
一朝喜结两姓爱	百岁不移半寸心
红花并蒂相映美	海燕双飞试比高
花灿银灯鸾对舞	春归画栋燕双栖
喜气满门春风堂上双飞燕	新事临阶彩霞池边并蒂莲
昔日同窗竹马青梅谈理想	今宵合卺高山流水话知音
千里良缘共贺联姻成大礼	百年佳偶定教偕老乐长春
志同道合海阔天空双飞翼	意长情深月圆花好两知心
四化常怀莫为情丝缠骥足	百年好合须将壮志展宏图
金结同心百岁夫妻良配偶	彩绳系手千秋鸾凤永和鸣
厨无美酒殊惭主	席缺佳肴亦宴宾
烟闻兰叶香风起	春入桃花暖气匀
有酒敬邀宾客醉	无鱼难尽主人情
满座嘉宾漾喜气	声声花炮迎新人
翡翠屏开槐影茂	鸳鸯池畔藕花香
客有隆情来庆贺	厨无美味实愧疚
宝髻巧梳金翡翠	琼窗闲咏碧蟾蜍
厨内精心调五味	堂前聚首会百朋
厨内青蔬酬上客	堂前珠履看新人
冒雨网鱼酬胜友	迎风摘果待嘉宾
大地香飘蜂忙蝶动相为伴	人间春到莺歌燕舞总成双
门书喜字乾坤乐	户进新人岁月甜
花从静处香能久	爱到纯时品自高
良缘一世同地久	佳偶百年共天长
银河喜看今夕会	兰桥蒙订百世缘
吹吹打打盈门喜	热热闹闹满堂春
共结丝罗山河固	永谐琴瑟地天长
枝生玉殿美连理	花满瑶池艳并头
交杯勿忘青云志	蜜月应存立业心
长天欢翔比翼鸟	大地喜结连理枝
向晓红莲开并蒂	朝阳彩凤喜双飞
勤劳伴侣同地久	劳动夫妻与天长
红花并蒂向阳开	银燕比翼凌空飞
云汉桥成牛女渡	春台箫引凤凰飞
芙蓉出水花正好	孔雀开屏月初圆
在天愿作比翼鸟	于地乐为连理枝
祝银河双星庆会	看金屋大礼观成
云路高翔比翼鸟	龙池涤种并头莲
两姓鱼水春永驻	百年恩爱花常红
琼楼月皎人如玉	绣阁花香酒似兰
海阔天空双比翼	月圆花好两知心
琴瑟永谐千年乐	芝兰同介百岁春
展翅相期凌云志	引吭高唱海誓歌
画眉笔带凌云志	种玉人怀咏雪才
君子攸宁于此日	佳人作合自天缘
种就福田如意玉	养成心地吉祥云
人共月圆天作合	志同家富土生金
连理枝头腾凤羽	合欢宴上对芹杯
情歌唤醒水中月	喜酒润开庭前花
堂前奏笛迎宾客	户外吹笙引凤凰
金鸡昂首祝婚礼	喜鹊登梅报好音
喜今日银河初渡	愿他年玉树生枝
莲子杯中金各酒	桃花盏上玉台诗
黄花酿酒三杯醉	绣阁增辉两烛燃
喜酒香滔蒲酒绿	榴花艳映佩花红
吾欢子喜重重喜	友喜戚欢个个欢
喜溢重门迎凤侣	光增陋室迓宾车
绿蚁浮杯邀客醉	蓝田得玉喜婚成
难有茅台酬上客	喜烧花烛映重门
喜至邀宾多车马	深愧设席少肉鱼
燕过重门留好语	莺过乔木报佳音
闲人免进贤人进	盗者莫来道者来
今朝淑女台前笑	来岁新生床上啼
喜联双喜联联喜	双对喜双对对双
筑巢紫燕春歌早	交颈鸳鸯柔情浓
院宅祥云参化育	室中喜气乐阳春
秦台有凤凭吹引	暖寝留熊待梦征
竹风留客饮	松月对宾筛
门前大道飞龙马	屋后崇山翥凤凰
门前绿水流将去	宅后紫莺祝贺来
前堂鸿禧笼华筵	后院福绥掩翠园
日照门前添喜气	花开院后吐芳馨
美德光前而裕后	韶琴颂古又歌今
子作阿翁舒晚景	孙为快好慰余年
我爱媳孙媳爱我	宾来宴酒宴来宾
家门有幸孙为婿	宾客尤欢子作翁
慰我翁姑常满意	愿他婆媳永和颜
五桂堂前身并茂	一兰阶下引丛芳
还虞月下身高子	不厌怀中揣上孙
今岁乐栽连理树	来年欣看绍裘人
了却爹娘心上事	喜迎儿女意中人
子媳有缘歌雅韵	翁姑含笑唱宜家
望子媳齐眉举案	酬亲朋弄盏传杯
礼乐于今歌大雅	媳儿立志奔小康
在户吉星昭喜气	适门淑女孝高堂
兄持烛灯招红影	弟阅诗书伴绿窗
完璧弟邀千里凤	勤劳兄伴五更鸡
乡邻皆道新人好	戚友咸夸老嫂贤
顺睦齐家和乃贵	忠诚处事乐与欢
谢我亲朋来燕贺	为余舍弟庆鸾俦
五风春绿双枝树	十雨夏滋并蒂莲
高风门第女儿孝	和睦人家姑嫂贤
堪夸堂上鸳鸯侣	喜慰闺中姊妹花
长兄已却三生愿	小妹应知四美篇
合家协力争当四美户	姑嫂齐心共建百花园
嫂姑姊妹亲兰房窃窃传笑语	杨柳燕莺伴春意融融唱丰年
举杯未饮情先醉	奋笔疾书语更新
座上漫谈同志爱	堂前合庆自由婚
文明诗友厅间客	亲睦朋邻座上宾
堂前奏乐迎宾客	门外吹箫引凤凰
把盏能抒宾主意	现书方晓古今情
座上飘香飘上座	堂中溢喜溢中堂
琼浆佳肴酬上客	金箫银管对新人
贵客频来祝大禧	礼房笑语贺佳人
高朋来四面	贵客喜八方
千声唢呐迎宾至	三盏祥醇把客酬
客自八方祝大礼	酒酌三盏贺新婚
薄酒酬宾图图热闹	烟糖敬友表表衷情
雪案联吟诗有味	冬窗伴读墨生香
万卷诗书宜子弟	一帘明月喜新人
满庭兰桂称心愿	几架诗书乐韶年
娱情笔墨写双喜	含意诗书歌百福
书到用时方恨少	喜临心上更知甜
世事洞明皆学问	人情练达即文章
天上长庚降	人间英物啼
锦绣生辉征喜兆	文明有种育宁馨
桂子呈祥多厚福	兰孙毓秀兆嘉惩
麟书征国瑞	熊梦兆家祥
英物啼声惊四座	德门喜气洽三多
天送石麟祥云绚彩	怀投玉燕呈梦应昌
荀氏八龙薛家王凤	燕山五桂蜀国双珠
以似以续克昌厥后	维熊维罴长发其祥
庆益桑弧四方有志	祥征兰梦一索得男
积得累仁自求多福	承先启后生此宁馨
瑞世有祥麟已为德门露头角	丹山翔彩凤还从华阀炫文章
风飘羽帐青云暖	春在壶天白日馨
净地月明生秀草	芳阶风暖长兰芽
佳气弃闾倍添春色	英声载路喜得宁馨
泉流东海千层浪	日照南山万树云
瓜瓞绵长征夏日	芝兰新茁似春初
子种莲房多多益善	梦延瓜瓞久久长绵
川媚山辉蓝玉朗	天高月满蚌珠肥
一朵芙蓉凝玉露	三秋桃实映流霞
月朗天高桂宫结子	地灵人杰崧岳生甲
雪映梅花杯映柏	日添宫线屋添芝
花前笑看獐书帖	梅下欣听鹤和声
瑞雪盈庭石麟降世	祥云护合玉燕投怀
玉种蓝田征合璧	树栽碧海喜交柯
两美同生家声毓凤	一孪竞秀世德征麟
两美同生祥开达适	一孪竞秀誉迈效祁
如此掌珠得未曾有	谁谓弄瓦聊胜于无
要知半子胜生男	中朗有女传家声
彩帨悬门兰质蕙心延美誉	明珠入掌柳诗茗赋毓清才
瓜瓞欣看绵世泽	梧桐喜报长孙枝
分杯河饼倍重庆	拄杖桑榆乐再孙
天赐石麟祥开四时	庭投玉燕瑞庆一堂
兰桂齐芳添麟趾	玉堂兴旺衍龙孙
喜见红梅新结子	笑看绿竹又生孙
声美凤毛绳其祖武	诗赓燕翼贻厥孙谋
庭前兰吐芳春玉	掌上珠生子夜光
桂子呈祥多厚福	兰孙毓秀兆嘉征
美济凤毛兰荪茁秀	谋贻燕翼瓜瓞绵长
有道明时兰为贵	天涯福气竹生孙
月窟早培丹桂子	云阶新毓玉兰芽
燕翼谋贻兰蒸茁秀	凤毛济美瓜瓞绵长
秋月儿生丹桂宝	春风父得紫兰芽
梧桐开四叶	燕翼孙添丁
喜见梧桐开四叶	福陈箕范祝三多
一门绕五福	四代庆同堂
一门五福陈箕范	四代同堂庆瓞绵
堂构象贤一门锡类	云龙继起四代同堂
美济凤毛家多令子	谋贻燕翼孙又添子
曾孙之穑黍稷翼翼	君子有谷瓜瓞绵绵
天赐石麟样开四叶	庭投王燕瑞霭一堂
喜见桐技开四叶	福陈箕范祝三多
德宏益寿	心阔延年
名高北斗	寿比南山
云山风度	松柏气节
福同海阔	寿比天齐
星辉南极	霞焕棒庭
秀添慈竹	荣辉萱花
耀腾宝婺	香发琪花
如松如鹤	多寿多福
天地同寿	日月齐光
梅开北海	曲奏南薰
立功立德	寿国寿民
德为世重	寿以人尊
人增高寿	天转阳和
春云霭瑞	宝婺腾辉
喜逢盛世	乐享遐龄
慈母温柔	宜家受福
心清益寿	德厚延年
萱堂日永	兰间风薰
人歌上寿	天与遐龄
芝荣五色	图献九如
人间二老	天上双星
寿同山岳久	福共海天长
寿考征洪福	和平享天年
松苍柏翠	人寿年丰
华堂衍庆	海屋添寿
仁慈殷实	获寿保年
云鹤千年寿	苍松万古春
筹添沧海日	嵩祝老人星
华封三转	天保九知
鹤翔百寿	盘献双桃
玉树盈阶秀	金萱映日荣
露滋三秀草	云护九如松
福禄欢喜	长生无极
花争秋后美	人敬老来红
慈萱春不老	古树寿长青
青松多寿色	丹桂有奇香
仁爱笃厚	积善有征
萱草千年绿	桃花万树红
佳辰逢岳降	瑞气霭春晖
盛世长春树	农家不老松
颐性养寿	屡获喜祥
征途心不老	峰顶景长青
冰清还玉洁	松寿更萱荣
菊水人皆寿	桃源境是仙
呈辉南极	霞焕椿庭
人老心不老	年高志愈高
鹤鸣千年寿	松号万古春
春风挥翰墨	佳气接蓬莱
松柏老而健	芝兰清且香
人间春酿熟	天上寿星明
沧海一轮月	骅骝万里心
壮猷为国重	元气得春光
松高显劲节	梅老正精神
与乾坤并寿	共日月同辉
九如天作保	五福寿为先
松龄长岁月	鹤语记春秋
平安添百福	长寿价千金
上苑梅花早	仙阶柏叶荣
北斗临台座	南山祝寿杯
绿琪千岁树	明月一池莲
庆云呈五色	寿礼献九如
松心长耐雪	鹏力会冲天
榴花红献瑞	柏叶翠凝香
泰岱松千尺	鹤山桂九苞
四化开新景	百花献寿诗
人老一身劲	花明满目春
雅室人不老	高山柏长青
寿同山岳永	福共海天长
南山欣作颂	北海容开樽
福同东海阔	寿共南山齐
松龄长岁月	鹤语寄春秋
紫气通南极	青云动北莱
佳辰逢岳降	瑞气焕春晖
慈竹青云护	灵芝绛雪滋
寿添沧海日	松祝小春天
泰岱松千尺	丹山风和苞
松鹤千年寿	子孙万代长
愿持山作寿	应供酒为年
澄潭一轮月	老鹤万里心
瑶池春不老	寿域日初长
岁寒知晚翠	春暖蕙先芳
青松多寿色	丹桂有丛香
蓬壶春不老	萱室日原长
萱花欣永茂	梅蕊庆先春
瑞霭全家福	光耀半边天
享共和幸福	作自在神仙
慈竹荫东阁	灵萱茂北堂
愿涌南山寿	熙如北海春
喜福微寿考	大年享乐平
松龄长岁月	鹤算纪春秋
乃文乃武乃寿	如竹如松如梅
福临寿星门第	喜到劳动人家
性情陶乐礼	年力富春秋
众仙团大会	天姥仰高峰
老骥志在千里	暮年心向长征
华封进三多祝	月恒颂九如歌
四时调玉烛	千算祝瑶觞
树老多神韵	年高有雅情
红带雅宜华发	白醪光泛新春
还我青春年少	问君古往今来
如梅花挺秀	似松树长青
九如天作保	五福寿当先
大德得无量寿	此老有当世名
福同天地共在	寿比日月同辉
清言多妙理	令德有遐芳
仁者无量寿	此翁更精神
仁者有寿者相	福人得古人风
福临寿星门第	春驻高龄人家
三呼应封人祝	九如颂天保诗
闲居足以养老	至乐莫如读书
如冈如陵如阜	多福多寿多男
生命在于运动	长寿因之勤劳
风高渐展摩天翼	山翠遥添南寿杯
洞里乾坤延鹤寿	壶中日月访仙家
紫气辉连南极	丹心彩映北楼
银花火树开佳节	玉液琼浆做寿杯
野鹤巢边松最老	仙人堂上雨初晴
桃花已发三层浪	玉树长含万里云
自是牡丹真富贵	果然松柏老精神
春放百花晴献寿	云呈五色晓开樽
心地高明宜福寿	精神爽朗自康宁
南极星临衡岳朗	北堂萱映海天明
人上征途心不老	志向峰顶景长春
丹室晓传青鸟宇	瑶池时进白云霞
幸福门前松柏秀	安乐堂中步履轻
但得夕阳无限好	何须惆怅近黄昏
霄汉鹏程腾九万	锦堂鹤算颂三千
寿同松柏千里碧	品似芝兰一味清
晚景弥坚松柏节	好风常度桂兰香
百花齐献南山寿	四化同歌盛世春
莫道夕阳光太少	无穷余热力还多
堂前燕舞迎春舞	院内莺歌祝寿歌
天上星辰可作伴	人间岁月不知年
白云欢歌翻寿曲	淡风坚石傲松年
三千蟠桃开寿域	九重春色映霞觞
柏节松心宜晚翠	童颜鹤发老精神
芝兰气韵松筠操	龙马精神海鹤情
体健神恰晚景好	书声墨韵老来红
春光满地人增寿	喜气盈门国肇昌
福禄寿三星共照	天地人六合同春
周天行健人常健	九日登高寿更高
行可楷模年誉德	老于松柏岁长青
长寿幸逢新社会	高龄全靠艳阳天
顶霜傲雪苍松劲	沐雨经风翠柏葱
年高喜赏登高节	秋老还添不老春
青山不老人长寿	华夏常春花永红
朱颜醉映丹枫色	华发疏同老鹤形
大鸟鹏飞九万里	蟠桃子熟三千年
举酒同歌无量寿	开怀共醉小阳春
行可楷模年称德	老夫松柏岁长春
佳作莫谈随老去	彩笔偏映夕阳红
栽竹尽成双凤尾	种松皆作老龙鳞
琼岛尚有千岁果	商山旧有五云芝
人如天上珠星聚	春到筵前柏酒香
琥珀盏斟千岁酒	琉璃瓶插四时花
从古称稀祝上寿	自今方始老益健
海屋有筹多附鹤	春林无处不飞花
古柏根深枝更茂	青松岁久叶常妍
瑶台牒注长生字	蓬岛春开幸福花
活百岁松钦鹤羡	数一生苦尽甘来
北苑春风挥翰墨	南山佳气接蓬莱
德如膏雨都润泽	寿比松柏是长春
杏花雨润韶华丽	椿树云深淑景长
室有芝兰春自韵	人如松柏岁常新
坐看溪云忘岁月	笑扶鸠杖话桑麻
心地光明宜福寿	精神爽朗自康强
寿考维棋征大德	文明有道享高年
藏山事业三千牍	住世神明五百年
南极星辉南岳客	九龄人晋九如歌
既效黄忠不服老	更同孟德有雄心
梅子绽时酣夏雨	萱花称满霭慈云
松风高驻千年鹤	玉露长滋五色兰
琼林歌舞群仙会	海屋衣冠百寿图
雨润萱花添秀色	风和兰竹报平安
紫气东来膺五福	星辉南耀灿三台
丹桂飘香开月阙	金萱称庆咏霓裳
萱草千秋荣玉砌	桃花方树映琼枝
人在家梓心在国	操如松柏节如梅
芝兰玉树竞娟秀	青鸟蟠桃共岁华
福护慈萱人不老	喜弥寿树岁长春
常思进取忘年老	何敢蹉跎度岁迟
椿树大年宜有庆	莲花生日正当时
蟠桃子结三千岁	萱草花开八百春
一阳喜见天心复	五福还推人寿先
愿慈母百岁不老	祝萱花万古长青
少坚不负青云志	老壮何甘白首心
喜逢盛世频增寿	乐遇晚年再建功
天朗气清筵晷景	辰良日喜祝慈龄
萱花挺秀辉南极	梅萼舒芬绕北堂
天护慈萱人不老	云弥寿树岁长春
山清水秀春常在	人寿年丰福无边
仙居十二楼之上	大寿八千岁为春
占得梁园为赋客	修成商岭采芝仙
南极星临五岳动	北堂萱映九州明
红梅绿竹称嘉友	翠柏苍松耐岁寒
惟盛世才能长寿	是贤良始可兴家
佛说无边寿者相	易称有庆善人家
其人为泰山北斗	是日也天朗气清
革命老人人人敬	良辰美景景景新
仙帨紫云南岳丽	绮筵红雪北堂开
春风绛帐谈家国	绕膝扶床戏子孙
萱草千秋荣玉砌	桃花万树映琼枝
青松增寿年年寿	丹桂飘香户户香
兰桂腾芳开寿城	儿孙贤俊振家声
琼岛尚存千岁果	商山旧有五云芝
兰桂腾芳开寿域	儿孙英俊继家声
高桂丛兰花锦绣	方瞳绿鬓玉精神
天护慈萱欣不老	云弥古树庆长青
自是荀郎堪继志	原是陶母善贻谋
黄花拟节凌秋晚	谏果回甘索味长
瑶台牒注长生字	蓬岛春开富贵花
西望瑶池降王母	南极老人应寿昌
祥鸾仪羽来三鸟	慈姥峰峦出九霄
风和璇阁恒春树	日暖萱庭长乐花
岭上梅花报春信	庭前椿树护芳龄
玉露常凝萱草翠	金风远送桂花香
天朗气清延晷景	辰良日吉祝慈龄
青鸟飞来云五色	碧桃献上岁三千
青松增寿年年寿	丹桂飘香户户香
丹桂飘香开月阙	金萱称庆咏霓裳
宝婺辉联南极晓	斑衣彩舞北堂春
萱草含芳千岁艳	桂花香动五株新
瑶池桃熟登琼席	玉树柯荣绚彩衣
年抛造物甄陶外	春在先生杖履中
瑶池喜晋千年酒	海屋欣添百岁筹
芝兰气味松筠态	龙马精神鸥鹤姿
天朗气清廷晷景	辰良日吉祝慈龄
芝兰玉树竞娟秀	青鸟蟠桃共岁华
宝婺辉联南极晓	斑衣彩舞北堂春
南极星临衡岳动	北堂萱映海天明
东海白鹤千秋寿	南岭青松万载春
山青水秀春常在	人寿年丰福无边
其人为泰山北斗	是日也天朗气清
玉露常凝萱草翠	金风远送桂花香
高桂丛兰花锦绣	方瞳绿鬓玉精神
高龄稔许同龟鹤	瑞世应知有凤毛
仙居十二楼之上	大寿八千岁为春
梅子绽时酣夏雨	萱花称满霭慈云
足食丰衣晚景好	勤耕苦读老来红
喜逢盛世频增寿	乐战晚年再立功
文移北斗成天象	日捧南山作寿杯
筠深慈竹荫东阁	花庆椿萱茂北堂
觞飞瑶阶来仙祝	瑞霭锦屏见寿星
琼林歌舞群仙会	海屋衣冠百寿图
蓍英洛社万家佛	草木平泉一品诗
年丰喜看花千树	人寿笑敬酒一杯
春意初衍梅色浅	和风选试彩衣鲜
冰如碧玉山如黛	凤有高梧鹤有松
堂前燕舞迎春舞	院内莺歌祝寿歌
五色云中三瑞草	九重天上万年松
福星高照满庭庆	寿诞生辉合家欢
白发朱颜登上寿	丰衣足食享高龄
三千岁月春常在	九十丰神古所稀
屏风家尽香山老	笠雨人称玉局仙
万里云霞开寿域	满地桃李颂春风
东方先生善谐谑	南极老人应寿昌
万户春风为子寿	车窗松雪谓天伦
金母晋桃开绮席	素娥分柱酿琼浆
光明心地恒增寿	爽朗精神自健康
松风高驻千年鹤	玉露长滋五色芝
长享忠厚无量福	欣承积善有余家
莫道彩毫随老去	佳篇喜映夕阳红
心底无私宜福寿	胸中有胆自康强
一阳喜见天心复	五福还推人寿先
文移北斗成天象	日捧南山作寿杯
春日融和欣祝寿	寿星光耀喜迎喜
万壑松风增寿色	四时花色壮高情
香山梅鹤饶清福	宅地神仙占大春
露邑青松多寿色	月明丹桂酿灵根
长寿幸逢新社会	娱亲喜有好几孙
周天行健人常健	秋日登高寿更高
苍龙日暮还行雨	老树春深更着花
五色云中三瑞草	九重天上万年松
行可楷模争颂德	寿如松柏岁长春
青春四海抒豪气	白首九州写壮怀
祖翁喜享南山寿	孙崽捧来西域桃
年高喜看花千树	人寿笑斟酒一杯
何忧白发头中满	且喜青云足下生
南极星临衡岳动	北堂萱映海天明
天朗气清延晷景	辰良日吉祝慈龄
八旬祖母瑶池瑞	四世儿孙庭院辉
报国不愁生白发	读书哪肯负苍生
祖父高龄满院乐	喜宾祝寿合家欢
风和璇阁恒春村	日暖萱庭长乐花
桃熟三千祝父寿	椿荣四世庆仙龄
家严鹤发无量寿	吾父童颜不老星
桃献池西侯逢浴佛	萤荣堂北荫庇馆甥
堂北萱荣馆甥舞彩	池西桃熟王母称觞
家父添筹松延晷景	南山献寿鹤祝长龄
祝慈母享百年长寿	教儿孙做四化尖兵
杏苑风和长春不老	椿庭日永上寿无疆
南山峨峨生者百岁	天风浪浪饮之太和
天与长春灵芝献瑞	人传济美宝树敷荣
东坡雅人宜作生日	西方寿佛长取新年
德祖寿高苍松不老	贤孙志远事业长春
立德立言于兹不朽	寿人寿世共此无疆
四化尽责松青鹤白	中华振兴景泰时和
白发朱颜宜登上寿	丰衣足食乐享晚年
百年长寿祝吾岂敢	终岁勤劳惟我不辞
序届阳春春同松柏	寿称国瑞瑞献芙蓉
柏翠松苍咸歌五福	椿荣萱茂同祝百龄
志大年高一身干劲	童颜鹤发满脸春风
寿酒盈樽春风满座	嵩山比峻南极腾辉
壮志凤飞逸情云上	赤心麟趾矢志天边
东坡雅人宜作生日	南田秋兴相期岁寒
鸠杖引年椒花献瑞	鹤筹添算椿树留荫
花好月圆庚星耀彩	云蒸霞蔚甲第增辉
兰阁风薰瑶池益算	萱堂日水彩蜕延龄
老当益壮雄心未已	晚节坚贞伟业何休
颂献嘉平诗歌福禄	人称寿考乐叙伦常
大德仁翁多福多寿	南山松柏愈老愈坚
乐庆丰收又庆母寿	高歌盛世先歌党恩
贞良温厚宜家爱福	仁爱笃恭获寿保年
福禄欢喜长生无极	仁爱笃厚积善有征
彩绚琼枝萱堂日暖	春生玉砌鸾佩风和
亲友登堂祝翁长寿	儿亲绕膝满室腾欢
花灿金萱瑞凝堂北	星辉宝婺彩映弧南
恭俭温良宜家受福	仁爱笃厚获寿保年
诗谱南山筵开西序	樽倾北海彩绚东阶
花发金辉香蜚玄圃	斑联玉树春永瑶池
乃冰其清乃玉其洁	如山之寿如松之贞
曲水湔裙春光正好	慈闱说帨寿算无疆
春酒迎樽春风满面	南山比峻南极腾辉
市隐四明楼高百尺	明颂三寿思沐九霄
爱国赤诚当享上寿	待家勤俭欢度晚年
红杏在林寿征二月	碧桃满树时待三春
璞玉浑金是寿者相	碧梧翠竹得气之清
白发朱颜喜登上寿	丰衣足食乐享晚年
红灯高照福庆长乐	爆竹连声寿祝久安
长乐未央朱颜华发	延年无极柏寿松新
膏透凝珠萱荣堂北	莱衣考彩菊满陔南
福寿双全国思家庆	新旧对比苦尽甘来
安保九如富贵寿考	幸封三福吉祥子孙
露湛花间萱荣堂北	日长蓬岛桃熟池西
福禄光明使君寿考	吉善长久宜我子孙
淑慎其仪绥我眉寿	柔嘉维则宜尔子孙
壮志凤飞逸情云上	灵芝献瑞仙鹤同年
功人龙阁名垂青史	心怀虚谷安度晚年
椿所延龄南山献颂	极星耀彩北海开樽
彩帨增辉情联姻眷	璇闺称庆光耀婺星
满目青山攀登无止境	长江春水接力有来人
白发朱颜宜登上寿	丰衣足食乐享高龄
称觞逢今旦喜且期颐	哺乳忆当年欲酬抚养
暮年逢盛世体康人寿	华夏颂德政国安民乐
修通家子弟仪班随莱彩	说老母期颐寿福备箕畴
玉露常凝瑶池春不老	金风送远寿域日开祥
葭琅应时梅花多姿吐艳	鹿车表德母寿不老长生
老境福临恩归共产党	新风喜降光照老来红
卓尔不群教育亦资内助	贤哉惟母康强可致长生
举酒称觞祝二老长寿	高歌引吭喜四化同春
天上太阳光照山河万里	人间高寿喜看兰桂盈庭
祝上寿期颐迭晋椿萱	交荫班随莱彩颂升恒
得一为贞寿世寿身寿国	持三不朽立言立德立功
一曲讴歌笑指南山作颂	几回醉舞喜倾北海为椿
长寿人饮长寿酒年年益寿	富强国唱富强歌岁岁富强
人寿年丰生活似糖似蜜	风和日丽风光如画如诗
酒冽花香幸有丰功酬壮志	时和人瑞喜从盛世祝遐龄
胜友如云同颂党恩深重	寿筵从简不忘国事兴隆
水秀山明八节四时颜不老	风和日丽千年万古景长春
飒飒金风声奏丰收乐曲	朗朗秋月光照长寿人家
儿孙团聚落座满酌健康酒	亲友远临绕席朗诵长寿诗
人道魏舒为宁氏外家宅相	天留郄鉴看献之祝嘏随班
一片冰心柏节松贞持晚景	两只铁手兰芳桂秀灿朝霞
老寿星长寿长寿再长寿	众同志祝福祝福还祝福
雪冷霜寒万里劲松曾傲岁	风和日暖千年古柳尚争春
曲谱南薰四月清和逢首夏	樽开北海一家欢乐庆长春
人逢盛世人添寿寿高五岳	地献丰年地纳祥祥漫三江
日永萱堂称觞合醉延龄酒	春长蓬岛设帨多簪益寿花
长寿人饮长寿酒年年长寿	常春国唱常春歌岁岁常春
乔木长青幸福只因逢盛世	流水不腐勤劳端合享遐龄
爱日喜长留多种萱花祝纯嘏	慈云欣永庇高擎桃实献华筵
世运维新赖有老成作砥柱	华封晋祝欣将诗句咏莱台
姻好附孙枝当年幸列东床选	瞻依同祖竹今夜辉增南极星
福地人勤荷锄戴月三星期	南山寿考傲霜凌雾一柏坚
世谊属通家晚辈宜为长者寿	良辰逢令诞今宵喜见老人星
慈母逾遐龄寿天寿地赖孝道	活佛修善德荫子荫孙留美中
介寿值良辰春满蓬壶延晷景	引年征盛典寿添海屋祝长龄
同德同心修到梅花原是福	多福多寿种来萱草可忘忧
齿德仰兼尊杖履追踪崇父执	期颐宜得寿矢弧在望庆年龄
愧无外祖风一片婆心爱自出	忝附诸孙列二门婚媾祝重闱
看娱老彩衣莱子并承诗礼训	侍传经绛幔韦母未亏视听能
瑞气满乡村人与青山同不老	暖风吹大地心随绿野共丰收
愿岁岁以今日良辰陈千秋雅戏	祝姥姥从古稀七十到上寿百年
慈竹茂长春宴启西池蟠桃献瑞	仙花明益寿浆斟北斗萱草忘忧
异姓如一家至戚相关无分畛域	洪畴备五福长春不老迭晋期颐
乏舅氏小子无知久仰慈云叨庇护	祝母寿长生不老永留爱日乐欢娱
不福星真福星即此一言可为君寿	已五十又五十请至百岁再征余文
晋爵在秋深自瑞气腾来三冬尽暖	称觞临岁杪知哲人诞后万物方春
吾辈当惜分明，万八千日莫虚掷	劝君更尽杯酒，四十九年应知非
数百岁之桑弧过去五十再来五十	问大年如海屋春华八千秋实八千
从康乐世溯降生辰无遗老成旋气运	当幸福年祝无量寿人同国柞永灵长
雅谊托雷陈载进兕觥喜见星辉联极婺	高风侪梁孟相庄鸿案长教晷景驻蓬壶
雅会集朋簪看台婺同耀燕誉清风敦世好	良辰开寿宇听琅敖叠奏鸾笙合乐谱双声
有令子名重和高菽水承欢庭前多种忘忧草	惟贤母望孚颜兹华堂晋祝头上新簪益寿花
转瞬新婴迎百日	展眉老幼庆天伦
新家百日添英物	福院三更哄俊娃
百天初入茫茫路	三代同倾眷眷情
啼歌几唱金莺晓	情照一张绣被春
啼声无语时牵众	娇面如花总快心
新开周岁蹒珊步	初启此生浩荡云
鹊唱晨祝周岁喜	家欢风送众亲临
万里鹏程先初步	一生大业待开局
即日初庾已有数	自此记岁不从零
周岁新添阖院乐	娇声又引睦邻来
迎喜一帧周岁照	同欢三代全家福
慧质父书工缮写	潜心姆教善听从
蚤识之无字	先征富有年
玉胜嘉祥碧茵雕龙	多銮幼慧紫石书成
席上裁诗惊座客	枕中偷秘轶群伦
胜成征祥看喜溢门楣良缘待袒东床腹	金銮毓秀知幼承家学妙年能写北山文
弱冠征年始学礼	清通人选已知名
设帨二旬闺门喜	双笄五载岁月新
射策方应如贾传	请缨志不让终军
自传英年勤苦学	薰常弱冠著贤声
双旬岁月缂丝美	五度春秋笄饰新
壮怀三十而立年	志在九旬且加月
芝兰乇树竞娟秀	青鸟蟠桃共岁华
而立大鹏	眼明自康
词赋登坛三十寿	功名强壮而立年
事业登坛方半甲	功名得路正英年
琼阁年华蟾圆一度	瑶池桃实鹤算三春
心阔如海三十年	德高似山立新功
室内芝兰三十春	国运昌盛树常青
壮志可行年方而立	修名自永寿祝无疆
辉腾宝婺三十寿	春发奇葩而立年
绮岁及笄双璧合	良辰设帨百年新
璇阁年华蟾圆一度	瑶池桃实鹤算千春
三十初进延龄酒	百年喜开益寿花
三十而立正青春	百年事业勇担负
燕桂谢兰年轻半甲	桑弧蓬矢志在四方
璇阁数年华恰合赡圆一度	瑶池看桃实预期鹤算千春
而立正当年且从壮岁求一举	相逢皆铁血但得此生报五星
正值壮年应知不朽方为寿	恰当而立须识文章可永年
历四承欢年养志	瑞气康宁杏争春
宝婺星辉歌四秩	蟠桃瑞献祝千秋
渭水春秋今得半	商山日月正悠长
不惑但从今日始	知命犹得十来年
蟠桃捧日三千岁	古柏参天四十围
蓬岛春浓开丽景	桑弧彩焕庆强年
何年宏开旬历四	养气蔚立祝多三
七篇道德称尧舜	四十功名耀古今
涵养已征心不动	芳辰初度仕方强
桃花雨润四十春	椿树云深淑景长
纪事桑弧当胜日	挑梁栋木正强年
际此欣逢设帨日	而今初倍及笄年
不惑但从今日始	明哲犹带甲子来
纪事桑弧当胜日	韬光市井正强年
四化方兴但得此身长报国	十功来半惟求大举终成全
四海蒸腾承先启后顶梁柱	十州振奋继往开来破浪船
相夫教子壶范久钦际此欣逢设帨日	积福筵龄期颐预卜而仿初倍及笄年
五十华筵开北海	三千朱履庆南山
五岳同尊嵩极峻	百年大寿日方中
二回甲子春初度	举国笙歌醉太平
云龙长驻三春景	安石平分百寿筹
五秩康强志如铁	十分健旺气若虹
花开周甲征全福	星耀长庚祝大年
志仰宣民勤学易	韵同周子爱观莲
年齐大衍经纶富	学到知非德器成
春秋不老臻高寿	甲子重新晋古稀
百岁期颐刚一半	九畴福寿已双全
半百光有身更健	几番风雨志弥坚
杯倾北海辰初度	颂献南山甲再周
百寿开来先百半	五福备至已五十
大衍宏开筮羲易	知非伊始进尧年
羲易数推占太衍	慈龄日晋颂无疆
蟠桃捧日三千岁	萱树参天五十围
读书砥行堪知命	安富尊荣且慕亲
温公正人耆英会	马氏咸称矍铄翁
璧合珠联征百岁	悬弧设帨祝千龄
花甲待圆十年再造	林壬人颂百岁半临
海屋添筹算周花甲	华堂舞彩庆洽林壬
天边客送千秋节	庭下人翻五色裳
不雕不琢年当服政	有为有守学到知非
瑞启芳辰香生桂子	算周花甲颂进林壬
一生事业今过半	百岁光阴日再中
伯玉同修问年日艾	黄金合铸其寿如松
学易假年符算大衍	知非进德庆协长生
燕桂谢兰年经半百	桑弧蓬矢志在四方
骏德遐昌龄周甲箓	鹤筹无算彩绚庚星
年齐大衍经纶富	学到知非德器纯
艾绶阳辉期颐益算	兰阶舞彩诗礼趋庭
五秩征年高门设帨	百龄益算海屋添筹
一心为公继前业	五旬传艺有后人
五岳同尊惟嵩峻极	百年上寿如日方中
甲子重新如山如阜	春秋不老大德大年
婺宿腾辉百龄半度	天星焕彩五福骈臻
德行齐辉一门集庆	福畴大衍百岁同符
花甲虽周犹可大显身手	精神尚旺定能再着先鞭
瑞集高堂鸳鸯宜福	筹添大衍松柏长春
五福演箕畴庆逢周甲	百龄祝纯嘏化治伏庚
屈指三秋天上又逢七夕	齐眉百岁人间应有双星
银汉泛仙槎天上双星并耀	箕畴逢大衍人间百岁同符
甲箓一杯酒进兕觥祝纯嘏	庚星重耀筹添鹤算庆长生
吾辈当惜阴百八千日莫虚度	君台更尽酒四十九年应知非
记八千为一春萱草千年绿	再五十便百岁桃花万树红
设帨遇芳辰百岁期颐刚一半	称觞有莱子九畴福寿已双全
不福星真福星即此一言可为君寿	已五十又五十请至百岁再敲余联
甲子重新新甲子	春秋几度度春秋
延龄人种神仙草	纪竹新开甲子花
一家欢乐庆长寿	六秩安康醉太平
不纪山中花甲子	应知天上老人星
春秋不老冈陵颂	甲子重添福寿花
玉芽久种春秋圃	青液频浇甲子花
八月秋高丹枫色	六旬人健老鹤形
祝遐龄三千岁月	游化日六十春秋
六秩华筵新岁月	三千慈训大文章
桃熟正逢花甲茂	兰开又遇寿龄添
一阳复体及耳顺	万物同春近眼来
一家欢乐庆长寿	六旬康泰宴蟠桃
前寿五旬迎花甲	待过十载祝古稀
重循甲子春初度	乐奏笙歌寿又登
纪寿欣逢新甲子	培香喜掇早丹花
八月秋高仰玉桂	六旬人健比乔松
花乃金萱开六甲	星其宝婺焕中天
祝颂遐龄椿作纪	筵开寿樽海为壶
延龄人种神仙草	纪算春开甲子花
玉树阶前莱衣竞舞	金萱堂上花甲初周
萱花堂北周荣甲	桃实池西献及辰
桃熟正逢花甲茂	兰开几阅寿筹添
青松翠竹标芳度	紫燕黄鹏鸣好春
骏德遐昌龄周甲篆	鹤寿无算彩绚庚星
宝婺星辉延六秩	蟠桃献寿祝千秋
杯倾北海辰初度	颂献南山甲再重
过去春光只两月	算来花甲已初周
笑逐颜开桃花擎实	年征耳顺萱草忘忧
偕老歌诗祥征六秩	同年益寿颂献三多
花甲初周茂如松柏	长庚朗曜庆溢桂兰
览揆逢辰台前合曜	延年周甲弧幢同悬
花甲虽周身手定能大显	精神尚旺先鞭犹可再着
百笄争妍祖国河山似锦	六旬双寿全家老少同欢
桂树冬荣三多喜报丁添竹	萱堂春茂六秩欣看甲映花
绕膝含饴莱衣竞舞	齐眉举案花甲同周
画锦堂开千宾引领	春庭宴启六秩齐届
海屋添寿林壬洽颂	乡间进杖花甲征祥
海屋添筹不纪山中花甲子	华封多祝应知天上老人星
弧蜕值嘉平堂上齐眉周甲子	庭帏绵福禄樽前众口祝期颐
慈竹荫千竿庆洽林壬日驻蓬壶春不老	萱花开半亩算周花甲筹添海屋寿无疆
一乡称寿母	七十庆古稀
千户称长者	七十曰古稀
人歌上寿	天与稀龄
七十枝如国	八千岁为春
风徽为今之范	仁寿乃古所稀
三千岁月春常在	六一丰神古所稀
七旬岁罢身依健	十度风经烛仍明
寿衍七旬辉宝婺	堂开三代乐薰风
入国正宜鸠作杖	历年方见鹤添筹
月满桂花延七秩	庭留萱草茂千秋
庆贺三多开寿域	祥开七秩映霞觞
七色云霞献寿锦	十分酒意溢华堂
杖国老人增景福	舞衣莱子更精神
金桂生辉老益健	萱草长春庆古稀
当看九州今正盛	谁言七十古来稀
此日萱庭登七秩	他年阆苑祝期颐
养成毛羽凌霄汉	并茂椿萱迈古稀
盛世祥征长寿宇	华堂庆衍古稀年
童颜鹤发寿星体	松姿柏态古稀年
年过七旬称健妇	筹添三十享期颐
国中从此推鸠杖	池上于今有凤毛
花甲重新今晋十	莱衣竞舞古来稀
福寿康宁登堂祝嘏	尊荣安富杖国征年
七度菊香秋后献	五云花洁日边来
庆颂三多琼筵晋爵	祥开七秩玉杖扶鸠
彩舞稀龄诗歌五福	花开益寿缕续长生
日月双辉惟仁者寿	阴阳合德真古来稀
圣世恩颁欣杖国	华诞庆衍快稀年
称兕祝鸠齐眉介福	苟龙薛凤绕膝承欢
日煦萱花云征异彩	天留婺宿人庆百年
翠柏苍松寿者相	童颜鹤发古稀年
鸠杖引年典隆二膳	鹤筹添算庆洽七旬
鹤算频添七旬览揆	鹿车共挽百岁长生
年逾七旬体神康健不服老	心联四化少长贤能共贴心
亿平生德风高尚心灵美	届古稀身体安康福寿长
莫道古来稀年齿已堪告杜老	若论一日长风流直欲唤莲兄
花甲鼓征帆满目青山花明柳暗	古稀鞭老骥两鬓银丝白发童心
论行在列女诸编可陶可沤可韦柳	介厘符九畴五福曰富曰寿曰康宁
介寿呈王母蟠桃一千岁花两千岁实	忘忧羡北堂萱草四十年苦三十年甜
岁过古稀多十载	预祝期颐二十年
菱花当面照黄发	竹叶入唇醉耋龄
喜登八旬高寿	乐享四化大福
四代斑衣松不老	八旬宝婺岁长春
八旬且献瑶池瑞	四代同瞻宝婺辉
鸾笙合奏和声乐	鹤算同添大耋年
杖朝步履仪容古	钓渭丝纶日月长
卓尔经纶传渭水	飘然风致入香山
春酒流香酣寿酒	耆龄添美祝遐龄
天边将满一轮月	世上还钟百岁人
杖朝步履春秋水	钓渭丝纶日月长
八旬鹤发同超母	七秩斑衣学老莱
耆年可入香山寿	硕德堪宏渭水滨
蟠桃已结三千岁	上寿还期二十春
沧海月莹寿母相	瑶台仙近女人星
卓尔经纶垂渭水	飘然风致入香山
奉觞载进常珍酒	设帨多簪益寿花
极婺齐耀同登大耄	椿萱并茂备致嘉祥
渭水一竿闲试钓	武陵千树笑行舟
八秩康强春不老	四时健旺福无穷
八秩康强春秋永在	四时健旺上寿期颐
八秩寿星孚盛国	十全老宿乐昌家
东方善谐南极昌寿	千龄予宴九老图形
桃熟三千欣献瑞	旬开八秩庆添筹
白发朱颜八旬大寿	贤孙孝子四世同堂
礼合告存荣邀天禄	年当梦卜光显国琛
梦叶渭滨兕觥上寿	筹添海屋鸠杖逾期
八方锦绣寿逢泰	十亿祥和富肇荣
天赐期颐长生无极	人间丰岁积庆有余
海屋添筹筵前众祝	绛人城杞算欠六龄
萱寿八千八旬伊始	范福九五九畴乃全
纬幔风和星辉宝婺	金闺日暖膳进常珍
设帨兰陔祥征八秩	奉觞萱室诗颂九如
八旬且献芝兰春自韵	四代同瞻松柏岁长青
八月称觞桂实投肴延八铁	千声奏乐萱花迎笑祝千秋
白发朱颜登八旬大寿	丰衣足食享五福晚年
逾古稀又十年可喜慈颜久驻	去期颐尚廿载预征后福无疆
盘献双桃更熟三千甲子	畴添五福庚同八十春秋
百岁能预期廿载后如今日健	群芳齐上寿十年前已古来稀
羡高年精神康健花甲重添二十载	居上寿齿德俱尊松年永享八千秋
八十岁葆素全真自是申公迎驷马	马千言修身冶性须看老子跨青牛
望三五夜月对影而双天上人间齐焕采	占八千春秋百分之一椿庭萱合共遐龄
华幔霭彤云宝婺腾辉合奏仙埚聆雅乐	绮筵浮绿醑常珍纷列高悬彩帨祝长龄
梓合功高庆麟阁双登寿母八旬跻八座	荪枝荫大值霓裳同咏名经千佛祝千秋
歌人生三乐	颂天保九如
山中桃熟九旬银	海上莲开七朵金
九旬鹤发同金母	七秩斑衣学老莱
一乡称寿母	九十颂奇萱
九志曾留千载寿	十年再进百岁人
耄耋齐眉春常在	孙曾绕膝福自多
庆花甲一周添半	祝萱堂百岁有奇
九如已应拳拳颂	十度再飞频频杯
愿效嵩呼歌福寿	还随莱舞祝期颐
堂北萱花荣九秩	天南宝婺耀千秋
南极桑弧悬九一	东方桃实奉三千
蟠桃经三千岁月	鹤算历九十春秋
人生五福当推寿	天保九如合献诗
南极桑弧悬九一	东方桃实献三千
九旬寿鹿舔黄者	十镇乡贤奉颂词
九老寿留千载笔	十年再进百龄觞
三祝筵开歌大寿	九如诗诵乐嘉宾
自古花甲膺殊遇	而今百岁亦寻常
九五殿开迎杖履	十常安举敬冻梨
桃实三千献仙果	椿荫九十驻春光
松柏常滋仙掌露	凤凰新浴璧池春
鸳弄笙喉同歌四化	篁摇凤尾齐颂九如
帨动春风寿延九裹	萱标绛色庆诞千秋
三千美景添筹算	九十风光乐有余
凝眸极婺腾双彩	屈指期颐晋一旬
桃熟三千樽开北海	春光九十诗颂南山
大好良辰春光明媚	重开令甲上寿期颐
颂献九如门楣喜溢	图陈五福寿字宏开
宝树灵椿三千甲子	龙眉华顶九十春光
慈寿延龄日增康乐	旬年屈指岁允期颐
堂北萱花荣九秩	天南宝婺耀千秋
九十春光永赐难老	三千甲篆悉数未终
寿宇宏开图陈百福	名楣喜溢颂献九如
桃花已发三层浪	人瑞先征五色云
桃熟三千老人星耀	春光九十喜鸟歌喧
登天髦年日增康乐	视天量寿迭晋期颐
算益卅年重周花甲	丹成九转喜遇芳辰
设帨溯当年喜花甲一周又半	称觞逢此日祝萱龄百岁添十
开上寿初筵九十曰耄	乐余年安康八千为秋
乐仰晚年漫道世间难逢百岁	宜登上寿且看堂上再庆十年
丘壑足烟霞九十年来留逸老	庙堂多雨露八旬寿后又生春
松菊并年高衍出箕畴增五福	椿萱同日茂算来花甲合三周
爱日伫期颐兰阶早酿十年酒	慈云周海岳菜彩犹栽一树花
鸿案久相庄还欣三祝华封九如天保	鹤筹同益算预识十年转瞬百岁期颐
家中早酿千年酒	世上长歌百岁人
莫道人生无百岁	须知草木有重春
古稀已是寻常事	上寿尤多百岁人
百岁为高寿	一言乃万金
百岁人歌长寿酒	万载花开太平春
寿同山岳歌百岁	福共海天祝千秋
天边将满一轮月	世上同尊百岁萱
乐奏寿弦歌百岁	德辉彤史祝千秋
君子有诗歌偕老	上寿自古称大齐
瑶池喜晋千年酒	海屋欣添百岁筹
百岁人歌长寿酒	万年花放太平春
九老曾留千载笔	十年再进百令觞
人生不满公今满	世上难逢我竟逢
盛世频开千叟宴	芳辰遥拜五云天
鹤算添筹逾百岁	鱼轩绚彩永千秋
蓬莱盘进长生果	婺宿筵开百岁施
称觞共庆千秋节	祝嘏高悬百寿图
里乘流芳荣褒绰楔	君子偕老景驻蓬壶
天赐期颐长生无极	人间百岁积庆有余
妇德交称百年殊寿	孙荣竞秀五世其昌
天姥高峰期颐祝庆	婺星朗耀日月舒长
家中早酿千年酒	盛世长歌百岁人
天边已满一轮月	世上还多百岁人
人瑞同称耀联弧帨	天龄永享庆溢期颐
百历延龄留晷景	九天华彩护慈云
上寿期颐庄椿不老	君公福履洪范斯陈
天上三秋婺星几转	人间百岁萱草长荣
桃熟三千瑶池启宴	筹添一百海屋称觞
古柏长春寿高百岁	蟠桃嘉会果熟千年
六十年度似芙蓉出水	二次甲辰如桃面方开
风危仰坤仪欢呼共祝千秋节	期颐称国瑞建筑应兴百岁坊
凤凰枝上共庆千秋节	松菊堂中高悬百寿图
九世同居如木之长如流之远	百年偕老吾闻其语吾见其人
孙子生孙五世其昌称国瑞	老人偕老百年共乐合家欢
上寿逾期颐一片婆心应锡谷	大龄绵岁月千秋仙果为分香
百岁大齐年偕老期颐绰楔褒荣称人瑞	双佛无量寿绵长日月瀛洲驻景傲仙家
二老共道	双寿齐祥
双星天象	全福人家
岗陵并祝	日月双辉
星云同献瑞	日月互争辉
日月双辉	河山并秀
椿萱并茂	庚婺同明
家中全福	天上双星
鹤筹添屈指	兕酒介齐眉
神仙联眷属	日月仰升恒
交柯树并茂	合卺筵同开
鸳鸯歌福绿	麟凤纪征祥
益寿花开并蒂	恒春树茁连枝
双星竞渡瑶池月	五桂争开玉海秋
梅竹平安春意满	椿萱昌茂寿源长
人近百年交柯树	天留二老合卺筵
桃李齐开春正好	屋堂合曜寿无疆
瑶觞春介齐眉寿	锦砌晖承绕膝花
天上人间齐焕彩	椿庭萱合共称觞
椿萱并茂交柯树	日月同辉瑶岛春
千岁桃开连理木	万年枝放太平花
凤凰枝上花如锦	松菊堂中人比年
华堂晓振云璇响	鸿案新餐雪藕新
鹤鹿同春人长寿	日月放彩岁大丰
少得情缘为伉俪	老而高寿颂平康
园林娱老儿孙好	夫妇同耕日月长
勤俭持家由内助	康强到老有余欢
凤引斑衣人绕膝	筋飞绿醑案齐眉
红梅丝竹称佳友	翠柏苍松耐岁寒
南极星辉牛女渡	北堂萱映凤凰枝
庆佳节双欣长寿	贺新春五谷丰登
乐府重重歌并寿	莱衣两两颂双星
紫电辉煌双鹤寿	春风浩荡百花开
并蒂花开瑶岛树	合欢酒进寿星杯
兰桂俱芳逢盛世	椿萱并茂遇高龄
齐眉笑倚鸠头杖	绕膝欢擎鹤口杯
位于内外家之正	寿以期颐福且兼
松木有枝皆百岁	蟠桃无实不千年
期颐百岁称人瑞	福寿双全蔚国华
丹凤传来王母使	青牛驾递老君书
松柏常滋仙掌露	凤凰新浴璧池春
饮来甘谷何云老	比到香山尚有期
凤萧合奏双成曲	鸿案相庄二老人
堂上椿萱夸并茂	壶中日月庆双辉
二经甲子春初度	一奏笙歌乐人怀
自古倡随勤不倦	于今老健福能齐
霞觞对举齐鸿案	莱彩联行舞凤雏
极姿当天皆福曜	艾蒲应候即良辰
双栖珠树千年鹤	三秀琼田五色芝
鸾笙合奏华堂乐	鹤算同添海屋筹
碧桃和露骄技发	青鸟传书比翼飞
白首相应多乐事	朱颜并驻祝长生
勤俭起家由内助	康强到老有余闲
荫茂椿萱连理树	厨开樱笋合欢席
同林娱老儿孙好	松菊堂中人比年
凤凰枝上花如锦	松炙堂中人比年
年享高龄夫妻同健	时逢盛世兰桂齐芳
妇德交称上寿允享	孙荣竞秀五世其昌
堂上椿萱夸并茂	寿中日月庆双辉
南极星辉牛斗度	北堂萱映凤凰枝
寿以期颐福且兼	位于内外家之正
五色云封连理树	万年枝放并头花
高士东篱年齐八秩	寿星南极光照千秋
志大年高一腔热血	童颜鹤发满面春风
嘏祝千秋国家祥瑞	筹添百算福寿双全
瑶草琪花骈陈左右	木公金母辉映东西
算益二旬重周花甲	寿登百岁永庇椿荫
绕膝承欢图开家庆	齐届至乐福备人间
弧帨同悬室家相庆	极婉前耀福寿兼全
日上月恒天运兆长生之庆	椿荣萱茂地灵钟不老之祥
行乐及时已得三万六千日	大德必寿预祝一百有廿年
二老并高年不让神仙眷属	九畴衍洪范兼全福寿儿孙
百岁祝期颐为半将来为半将过	重光瞻日月曰如其升曰如其恒
八千岁为春天上碧桃正骈枝结实	九五福曰畴云开青鸟亦比翼飞来
百岁庆期颐绰楔褒荣尊崇真是人中瑞	九如歌日月蓬壶驻景逍遥为作地行仙
喜溢椿庭椒盘献瑞	欢承萱宝柏酒称觞
蟠桃天上骄枝实	凤管人间合鹊调
鸿案齐眉宜春启瑞	兕觥介寿永日腾欢
鸳谱夙联盟椒酒称觞犹是合欢初合卺	鹤筹新益算莱衣舞彩还欣同月又同年
弧帨同悬桃符竞艳	觥筹交错椒酒流香
弧帨喜同悬二美征祥兰寝讴歌延淑景	瑟琴歌共升百年偕老椒盘献瑞祝遐龄
节到中和春正好	缘深伉俪寿无疆
红杏争春群芳献瑞	白华美志二老承欢
节纪中和阳春二月	缘深伉俪偕老百年
鸿案庆齐眉寿域宏开正喜百花作生日	鹿车欣挽手衡门偕隐永教二老的长春
览揆值良辰正绿果青囊酒进宜春添喜气	登堂庆荣诞看桑弧华帨诗歌偕老祝长生
春满蓬壶延晾景	声驰琴瑟奏仙埙
桃李争春喜双寿	椿萱并茂看齐眉
桃李齐开春正好	台前合曜寿无疆
酌斗称眉觥齐鸿案	悬弧设帨乐奏鸾笙
椿萱并茂多福多寿	桃李联盟宜室宜家
桃李联芳长春不老	极婺并耀纯嘏弥长
弧帨同悬葵心向日	椿萱并茂婪尾留春
樱笋厨开兕觥进酒	椿萱荫美鹤算添筹
芍药栏边花开富贵	椿萱堂上祝寿期颐
海屋并添筹正逢首夏清和留得长春富贵	华堂同祝嘏不似人间夫妇竟如天上神仙
蒲艾同芳良辰览揆	椿萱并茂美意延年
地洽良辰何山并寿	天逢端午日月双辉
地腊逢辰河山并寿	天中建午日月双辉
鸿案眉齐碧筒酒熟	鹿车手挽瑶岛春长
沉李浮瓜兕觥进酒	悬弧设帨鹤算添筹
荷沼颂鸳鸯碧筒杯里倾佳酿	芝田游鹤鹿青玉案前祝大年
上寿祝良辰是桃熟千秋却到骈枝生色	佳缘联嘉藕正莲开并蒂会看举案齐眉
弧帨同悬秋光初到	琴瑟在御夏屋宏开
椿茂萱英畴增五福	庚明婺焕辉映双星
椿萱并茂亦柯树	瓜果同开合卺筵
弧矢同悬风清七夕	台前合曜彩彻双星
览揆值良辰银汉鹊桥填欲就	有缘联嘉藕金鸳谱绣长新
月圆人共圆看双影今宵清光普照	客满樽俱满羡齐眉此日秋色平分
家庆团圆蟾宫月满	无锡纯嘏鸿案凤长
高士东篱好花并蒂	寿星南极圆月交辉
朗抱赠宫同照影	良缘鸿案永齐眉
仙侣友生比翼共乘丹凤下	中秋介寿重轮齐涌月蟾来
椿萱并茂伉俪和谐益寿平添鹤筹算	风月俱佳啸歌清鬯同心共挽鹿门车
松菊未荒三径乐	椿萱偕老百年长
同志鹿车菊花隐逸	齐眉鸿案桃实神仙
伉俪雍和庭放菊	风光良好面如春
菊酒萸囊琼筵晋爵	雕弧锦帨玉杖扶鸠
椿萱并茂河山寿	庚婺同明日月辉
弧帨喜同悬正上寿奉觥	棒萱看并茂是齐眉举案
梅苑生春诗歌偕老	蓉屏耀彩寿祝同庚
节届小春梅花纸帐甘同梦	香添长寿蓉镜妆台证合欢
益寿如添五纹钱	合欢同进百年怀
柏节松贞持晚景	兰芳桂实灿朝霞
葭琯征时兕觥同酌	兰阶爱日鸿案相庄
葭琯动飞灰爱日迎春正喜一阳初复	莱衣试舞彩寿星朗耀还欣二老同庚
椿萱与桂兰并茂	松柏偕天地同春
天竹腊梅相映成色	寿山福海共祝无疆
弧帨同悬门画虎	琴瑟静好杖扶鸠
饮蜡吹豳嘉平纪月	悬弧设帨偕老延年
鹤算同添华堂笃枯	鹿车并挽寿宇延春
添来腊月风光椿萱与桂兰并茂	耐得岁寒时节松柏偕天地同春
喜添凤侣双飞翼	欢祝驾俦百岁春
桐叶征祥桃花纪算	鸾俦比翼凤侣添翎
置闰定时喜添凤侣双飞翼	延年益寿欢祝鸾俦百岁春
人如天上珠星灿	春到筵前柏酒香
年抛造物陶甄外	春在先生杖履中
凤纪调元春滥萱幄	鹤筹添算庆溢兰陔
淑气初衔梅花浅	和风迭试柳枝鲜
萱草忘忧征懿德	椒花献颂祝遐龄
彩帨增辉兕觥叶庆	璇图启瑞凤历纪元
喜逢华诞歌春酒	好向新年戏彩衣
梅帐寒消花益寿	萱帏春护草生香
五福梅开筹添鹤算	三多竹报酒晋兕觥
桃符新换添佳气	蓬矢高悬祝大年
宝婺辉联南极晓	斑衣彩舞北堂春
黍谷回春椒花献瑞	萱堂称庆柏酒延禧
辛盘荐新西母蟠桃子熟	酉樽益寿北堂萱草春长
椒颂庆遇龄亥算征时同练老	椿阴森佳气寅回应律启青阳
谷旦春王淑气初衔梅色浅	良辰介寿和风还试彩衣鲜
乾始启昌期春到兰闺延淑景	坤仪钦懿德喜腾萱室祝遐龄
三祝华封瞻泰斗	二分春色到花朝
花开红杏酣春色	酒进南山作寿杯
纳杏在林时维二月	紫芝纪算数合九畴
瑶岛香浓芝草圃	五楼人醉杏花天
天护慈萱春不老	门悬彩帨色常新
杏圃春融寿添海屋	兰阶日丽彩舞莱衣
鹤算添算杏仙上寿	鲤庭舞彩莱子承欢
二月庆芳辰大会群仙开杏苑	一心悬宝婺骄臻五福备箕畴
杏花正芳辰红杏尚书欣祝嘏	花朝即生日百花仙子乐称觞
花逢修楔林如画	酒泛瑶池客尽仙
余庆咸符福极会	延春雅奏寿人歌
椿萱并茂多康多寿	桃李联盟宜室宜家
蟠桃已结瑶池露	玉树交联间苑春
东序兰芳三春草	北堂营村百世花
紫阅生春香添金鼎	黄钟应律冰贮玉壶
花繁曼倩三千树	草就蒙庄十万言
海屋云开筹添八百	琼林雾霭桃熟三千
桃瑶岛长春开寿宴	竹璇闱永日庆生辰
桃熟三千佳果平分仙洞	春光九十称觞偏占芳辰
锦帨呈祥共春旗一色	瑶觞献瑞祝寿母千秋
鹤转笙惟似奏霓裳月殿	算摇凤尾恍迎瑶岛神仙
驹隙数流光春去旧雨夏来今雨	兕觥称华诞日长小年寿晋大年
蔷薇喜浥琼林露	芍药祥开金带围
四月清和节临首夏	百年康健树种恒春
首夏清和长春富贵	慈云庇护爱日绵长
荼蘼开到清和月	芍药应称富贵花
令节清和春留姿尾	大年福寿酒进遐龄
桃实呈祥骄臻百福	极星拱寿辉映三台
树茂椿庭添福影	香斟佳酿祝遐龄
酒泛金樽以介眉寿	花开琼岛有婪尾春
萱茂华堂辉生绵帽	仁爱笃厚获寿延年
设帨庆良辰正常北延春树来萱草	称觞逢令旦又郊南迎夏开满槐花
正交端午作生日	惟有昌阳可引年
端午气清延晷景	薄筋杯满祝慈岭
槐院风清鹑躔应候	椿庭日永鹤算添筹
午琯延鳌尊杖履	壬林颂美叶笙歌
艾叶香浓笼彩帨	榴花色艳映斑衣
桃实凝香樽倾北海	榴花献瑞诗谱南山
正值榴花多结子	共擎蒲酒祝添庚
蓬矢高悬逢午月	蒲觞上献祝庚星
绮席称觞香浮蒲绿	华堂舞彩色映榴红
寿母酒献千年绿	榴花火明五月红
华祝三多芝呈五色	榴开百子艾保千年
适庆生申文翠香霏绮席	惟兹月午榴红色映斑衣
午月庆芳辰堂前萱草分眉绿	婺星耀瑞彩阶下榴花照眼红
设帨应良辰瑶轸风薰琴鸾叶弦流雅韵	称觥逢令旦璇图云丽筹添鹤算祝遐龄
北海樽前领寿酒	南黄曲奏理瑶琴
祝效华封南薰奏曲	游同河朔北海开樽
养性怡情莲称君子	抚辰览揆椿祝大年
寿宴宏开荷塘风爽	华堂高启棒苑云深
椿树大年宜有祝	莲花生日正当时
鸿案眉齐瑶池桃熟	鹿车手挽荷麦风香
梅子绽时酣夏雨	萱花称满霭慈云
北极供星群开高寿	南风送暖曲奏长生
兰阁风薰绮琴解愠	营庭日丽彩缕延龄
莲沼鸳鸯歌福禄	椿庭鹤鹿祝年龄
火枣交梨众仙上寿	冰桃雪耦一室招凉
碧沼荷开灵娥初度	瑶池桃熟王母长生
樽倾北海欢从三伏游河朔	曲奏南薰喜向季夏祝华封
萱草祝长春奏乐新翻金缕曲	莲花庆生日称觞合献碧筒杯
饮无非碧筒杯介寿欣逢天贶节	游何必赤松子闲身即是地行仙
设帨值良辰碧苑桃开呈丽景	称觞逢令旦瑶池桃熟启华筵
寿锡天孙多富贵	畴陈箕子益康宁
坐看溪云望牛女	笑扶鸠杖话桑麻
古语遥传富贵寿考	遇龄迭晋耄耋期颐
金爵频添千斗酒	玉阶联发五花樽
巧逢天上星辰聚	乞得人间福寿多
寿考长生天孙语妙	乞巧令节老人星辉
花开指甲飞金风	星耀长庚贯斗牛
银汉双星传吉语	璇闺百罗祝慈岭
云捧彩鸾西王母至	花开金凤南极星明
我求懿德终温且惠	天赐纯嘏俾寿而康
鹊贺填桥天孙锡寿	兕觥进酒王母临筵
凉风吹玉律声奏音乐	爽气接瑶池光浮云霞
云捧彩鸾王母至	花开金凤天星来
修德早膺天爵贵	参禅久悟木犀贤
桂殿秋高霓裳奏曲	椿庭日暖莱彩联芳
桂序秋高瑶阶设帨	萱堂昼永绮席称觥
树茂椿庭添福荫	香斟桂酿祝遐龄
上寿长生中秋今节	良宵不放明月前身
萱茂华堂辉生锦帨	桂开月殿曲奏霓裳
节届中秋月圆人寿	寿增上算桂馥兰馨
月到中秋紫府名标金斗篆	人征上寿彩衣香惹玉炉烟
惠然肯来正丛桂留人华堂载进兕觥酒	永锡难老是灵椿益寿海屋平添鹤算筹
千秋金鉴昭明德	八月银涛壮寿文
纬县年高祥征算亥	黄华酒熟庆洽林壬
酌斗称觥醉尝菊酒	拈花插鬓香弄萸房
秋爽璇闺菊花益寿	辉腾宝帨萱草忘忧
松菊不殊陶令宅	图书似泛米家船
菊满篱东称寿客	萱荣堂北祝慈龄
菊酒延年人方送酒	桃糕晋祝客至题糕
东海筹添同庆祝	南山颂献赋登临
数备箕略多获福	同倾菊酒乐延年
东海添筹春秋高矣	南山采菊丰致悠然
婺焕重霄畴呈五福	时维九月序属三秋
萱室发荣光寿祝箕畴备五福	菊篱绽秋色天教晚节傲群芳
令诞处悬弧正菊绽重阳喜见琪花开益寿	嘉祥称览揆是畴陈五福定知宝箓注长生
顿教萱所添春色	记取蓉屏写寿文
梅岭传香来报春信	萱闱养寿晋益慈龄
红叶丛兰花锦绣	方瞳绿鬓玉精神
岭上梅花报春信	阶前萱草护慈龄
海屋筹添图开福寿	华堂宴启序届阳春
日丽萱闱祝无量寿	香传梅岭届小春天
莱舞堂前娱晚寿	梅开岭上得先春
良月筵前介眉酒熟	小春气暖绕膝人腾
梅馥岭南小春有信	萱荣堂北寿算无疆
百算筹添沧海日	三呼嵩祝小阳天
查饵日永添长缕	蔑南灰飞舞彩衣
葭管灰飞平添瑞气	兰陔日永进祝良辰
云捧彩鸾西苑雪瑞	日辉金凤南山松青
来复天心推七日	贞恒慈寿祝千秋
霞琯应时梅花志喜	鹿车表德鹤算增年
初动一阳日添宫缕	骄臻百福春到庭帏
葭琯阳回瑶池春永	萱庭庆集海屋筹添
五福骈致萱草并水仙竞艳	一阳初动算寿与宫纱同添
扶鸠竹外看晴雪	坐石松间煮紫芝
青山有雪存松性	碧落无云称鹤心
颂献嘉平诗歌福祚	人称寿考乐叙纲常
北海酒倾歌寿考	南檐日暖集嘉宾
喜看梅黄逢腊月	寿添萱绿护春云
天竹腊梅相辉成趣	寿山福海共祝无疆
日驻蓬壶驹留余晾	春延萱鹤纪仙筹
请谱南山筵开西序	樽倾北海梅放东台
玉树清香金直日永	绿波放早翠柏春长
五色芝茎慈闱祝寿	百年萱草新岁延龄
天锡遐龄肇八千岁为春之旦	日临初度应十二月成物之功
紫阁生春香添金鼎	黄钟应律冰贮玉壶
腊月颂嘉平视堂上金萱日茂	婺星显灿烂喜庭前翠柏冬荣
翠管银罂添喜气	桑弧蓬矢祝遐龄
挹道叶天和看瑞气腾来三冬尽暖	称觞临岁秒知哲人生后万物方春
延年益寿萱花茂	吉日良辰蓂荚添
酌酒称觞筵开百福	延年益寿斗指双岐
萱祝延龄藕呈益节	蓂占庆瑞桐喜增祥
藕节增添逢闰岁	椿荫茂美护遐龄
益藕添桐逢闰月	悬弧设帨庆良辰
龙辔回环归奇象闰	鹤筹添算益寿延年
蓂荚呈祥悬弧令旦	梧桐纪候佳郁长春
凤尾添翎萱阖日永	鹤筹益算蓬岛春长
念己身出自外家应许燕谋歌祖德	惟仁者必得大寿喜随冀尾附孙行
人道魏舒为宁氏外家宅相	天留郄鉴看献之祝嘏随班
愧无外祖风一片婆心爱自出	忝附诸孙列二门婚媾祝重慈
彩帨高悬福全箕范	重闱大喜忝附兰阶
为多士师半子及门公冶	惟仁者寿一言写照宣民
仰丈人峰名高北斗	修半子礼寿献南山
甥馆护慈云喜进桃觞开绮席	馆甥叨福荫孙行附列祝千秋
桃熟池西图呈王母	萱荣堂北荫庇馆甥
足征盛德如公寿可必得	若说不才像舅我何敢当
咏渭阳诗献冈陵颂	承宅相誉陈洪范篇
葭琯应时梅花多姿吐艳	鹿车表德母寿不老长生
自渐乏舅风小子无知久仰慈云叨庇护	今喜祝母寿长生不老永留爱日乐献娱
祖翁喜享南山寿	孙崽捧来西域桃
德祖寿高苍松不老	贤孙志远事业长春
祖父高龄满院乐	嘉宾祝寿合家欢
祖母今朝称寿母	慈龄盛世享遐龄
祖母添寿福星高照	嘉宾满堂喜气咸宜
八旬祖母瑶池瑞	四世儿孙庭院辉
桃熟三千祝父寿	椿荣四世庆仙龄
家父添筹松延晷景	南山献寿鹤祝长龄
家严鹤发无量寿	吾父童颜不老星
乐地乐天福如东海	如松如柏寿比南山
天护慈萱母永健	云垂玉树岁长青
祝慈母享百年长寿	教儿孙作四化尖兵
王母承欢瑶池锦	慈颜不老萱圃香
堂室生辉荣萱志喜	慈龄长乐获寿延年
门下荷栽培无当日安有今日	堂前祝纯嘏愿先生不老长生
椿树延龄南山献颂	极星耀彩北海开樽
愧小子樗材幸蒙雕琢方成器	祝尊师椿寿长许追随不计年
达材成德幸相期坐小子春风一月	耳顺从心无止境祝先生杖履千秋
看娱老彩衣莱子并承诗礼训	侍传经绎幔韦母来亏视听能
卓尔不群教育亦资内助	贤哉惟母康强可致长生
精神爽朗会享福福如东海	心地光明登高寿寿比南山
喜亲家白发朱颜宜登上寿	好光景丰衣足食乐享晚年
睦邻一家福海朗照千秋月	古稀七旬寿域光涵万里天
散天女花证菩提树	拜观音佛祝罗汉松
开蟠桃花祝无量寿	证菩提果观自在心
百道泉光飞锡杖	一轮月影人霞觞
真心悟如来祝嘏称觞四座同参无量佛	空中现自在歌功颂德十方都是有缘人
九转丹成三生果证	千年桃熟百岁芝荣
壶裹洞天藏日月	山中甲子自春秋
庭畔古松多寿色	树间幽鸟少凡声
气满函关骑青牛过去	筹添海屋招白鹤飞还
人间留驻神仙驾	天上颂来父母官
一路福星口碑载道	万家生佛万寿无疆
立言立功立德	寿国寿世寿民
自是君身有仙骨	无如极责又长生
经济医时昭一代	功名寿世足千秋
策杖挟鸠善人征寿相	调琴伺鹤仙署驻长春
庆洽悬弧娱晚景	恩周挟纩驻春晖
勋业光日月	精神富春秋
帐下东风开寿域	椰前皓月照严城
寿算长绵甲子从人间溯及	武功丕振将军自天上飞来
百年日月长生园	万卷诗书不老丹
千首诗堆青玉案	九宵去覆紫芝林
文名高北斗	颂话献南山
文星彩放三千界	人寿欣逢入百春
云近蓬莱成五色	花开桃李列千行
万春方华千龄始旦	群流仰境大雅扶轮
执教鞭有年乐得英才济济	奉寿觞祝嘏欣来髦士峨峨
立德立言于兹不朽	寿人寿世同此无疆
有志经营善人是富	无疆悠久寿考维祺
长者绝无市井气	寿翁久有牛山名
献桃实三千年刚征瑞应	演箕畴九五福德致嘉祥
喜庭前生意偏多瑶草琪花春自	瞻堂上寿翁不老珠颜玉色日方
堂构相承椿庭介寿	其裘克绍梓舍腾欢
输巧娄明得天独厚	彭年绛甲长乐杀央
大匠经营群推老手	高年颐养共祝长春
绎老疑年二首六身稽亥算	朱颜转少入材九职耐辛勤
香稻清肠仙桃适口	奇花益寿佳果长生
春酒介眉祝无量寿	秋田茂稼歌大有年
羡煞田舍翁岁月优游得长生秘诀	胜彼富家子晨昏定省博老父欢颜
乐圃生香别有壶中日月	芝田纪算伊然世上神仙
著手成春夙精妙术	存心济世永享遐龄
寿享遐龄仁心仁术	功同良相医国医民
妙手回春脉理精通能益寿	存心济世活人多处自延年
医国医人同兹医意	寿民寿世亦以寿身
科学专家刀圭巧擅西欧术	仁心济世寿算明添南极星
言论文章放之四海皆准	功勋伟业长与日月同光
寿比萧伯纳	功追高尔基
七十更强歌战士	万方救难赖人师
述生圣之玄意，整国家之不齐，入此岁来年七十矣	奉觞豆于国叟，致欢欣于春酒，亲授业者盖三千焉
海为龙世界	云是鹤家乡
写诗写文章亦庄亦谐如口出	反帝反封建不屈不挠见胸期
南山峨峨生者百岁	天气浪浪饮之太和
西池庆筵	蟠桃献颂
瑶池桃熟	鹤算增年
萱草长春	婺曜长昭
萱颜不老	寿衍千秋
宝婺星辉	古稀慈寿
萱阁日永	萱荣堂北
春云霭瑞	庆溢兰征
如竹如梅	慈颜长春
松岳长生	名高元老
蓬壶日永	庆衍古稀
春秋不老	鹤算遐龄
莱衣献彩	福如东海
觞咏香山	人中真瑞
南极寿翁	松鹤延年
海屋添筹	以介寿目
渭水经纶	古柏长春
椿萱并茂	福海寿山
双寿无边	德征鸿案
桂馥兰馨	偕老齐眉
伉俪寿禧	弧帨齐辉
堂上椿荣高悬弧矢	庭前莱舞克绍箕裘
羡孟光贤助公输巧	识天孙锦添海屋筹
输巧娄明得天独厚	彭年绛甲长乐未央
经画名言佩服敬姜劳逸论	修明内则寿词姆教组训篇
绛老疑年二首六身稽亥算	朱颜转少人材九职耐辛勤
十指费艰辛敢忘慈母手中线	一心图孝养喜舞莱儿身上衣
大匠羡班输中矩中规统率鸠工推老手	高风侪梁孟多男多寿相庄鸿案庆齐眉
劳工神圣食力有余甘自强不息天行健	寿考康宁卫生无他术吃苦方居人上头
垂裕后昆肯播肯谷	永锡难老多福多男
堂北萱荣慈云护舍	陔南兰洁爱日负暄
莱彩娱亲伯歌季舞	豳衣献寿公帨妪欢
香稻清肠仙桃适口	奇花益寿佳果长生
公悦妪欢曾孙寿考	伯歌季舞孝弟力田
春酒介眉祝无量寿	秋田茂稼歌大有年
率时农夫思媚其妇	以介眉寿相敬如宾
小正农祥寿星拱极	大田稼茂春酒介眉
操守贞松苦节好将彤管述	构贻式谷春风还试彩衣鲜
羡煞田舍翁岁月优游得长生秘诀	胜彼富家子晨昏定省博老父欢颜
商界执牛耳	箕畴晋鹤龄
货殖成书多岁月	陶朱乐业永春秋
堂构相承椿属介寿	箕裘克绍梓合腾欢
利人又利己	多寿更多财
有志经营善人是福	无疆悠久寿考维祺
输巧娄明得天独厚	彭年绛甲长乐未央
仁人具寿者相	商贾做富家翁
学擅陶朱南山献寿	才同管子北海倾樽
肯构肯堂君子有谷	多男多福寿考维祺
长者绝无市井气	寿翁久有斗山名
书成货殖推端木	彩舞欢娱得老莱
创业维艰克勤克俭	相夫以敬多谊多情
献桃实三千年刚征瑞应	演箕畴九五福备致嘉祥
鸿案相庄井臼还资贤伉俪	鹤筹添算冈陵合咏古诗歌
春日启华筵为慈亲添寿算	婺星耀天市有令子振家声
绛悬古春秋花好月圆双寿宴	朱门真富贵地灵人杰五经常
阛阓年高酒进宜春羡梓舍	井廛日永诗歌介寿乐椿庭
歌咏太平年利市持筹赢三倍	涵濡共和福华堂绚彩庆千春
市廛钦经济大才争说老成无遗策	海屋听神仙闲话早知寿算有奇赢
喜庭前生意偏多瑶草棋花春自富	瞻堂上寿翁不老珠颜玉色日方中
勖夫子以勤旦戒鸡鸣商业颇资贤内助	修已身惟俭筹添鹤算情无不老古长春
阛阓仰慈云宝婺星明设帨良辰添喜气	蓬莱驻春景璇闺日永称觥乐事祝遐龄
教子克成名为箕为裘握算持筹贻式谷	修德必获报多福多寿称觞晋斝祝灵椿
相夫子鸿案修仪商业云蒸井臼还资贤伉俪	庆良辰先俄晋酒情天日永冈陵合咏古诗歌
宇宙庆承平好教握算持筹正阛阓云蒸井廛日丽	家庭腾欢乐相与称献酌斗况桑弧高挂华帨齐悬
相夫教子并播贤声货殖振鸿图庭前多种忘忧草	酌斝称觞为祝纯嘏慈龄添鹤算头上新簪益寿花
华堂祝纯嘏	绛怅煦春风
书多真富贵	寿大小神仙
如山如阜如冈陵	多福多寿多男子
德与年皆进	寿同福并高
云近蓬莱成五色	花开桃李列千秋
多德多才多慧悟	美名美寿美儿孙
天将以为木铎	人望之如神仙
白沙诗思同激节	王局文章继老泉
桃李满园祝寿考	诗书盈榻度春秋
有酒盈樽为先生寿	作文献颂修弟子仪
文名高北斗	颂语比南山
泊辈门墙承化雨	先生杖履照春风
子读诗书思获画	人观体法祝萱龄
藏山事业三千牍	往事神仙五百年
万春方华千龄始里	群流仰镜大雅扶轮
天保一诗俾尔戬谷	华封三视为君称觞
云近蓬莱成五色	花开桃李列千行
后辈门墙承化雨	先生杖履煦春风
教子成名贤齐孟母	娱亲献寿彩舞莱儿
宴启华堂喜见庥姑东降	灯悬绛怅欣看昆母西来
画荻仰母仪令子才名追六一	蟠桃介慈寿仙家岁月记三千
看娱老彩衣莱子并承诗礼训	侍传经绛幔韦母未亏视听能
寿世文章一代斗山韩吏部	等身著作六经鼎海郑司农
乐羊子学业有成原赖断机励志	孟德耀相夫以敬自应举案齐眉
寿考作人髦士奉觞齐向椿庭祝嘏	诗书启后华堂酌斗岂真菽水承欢
达材成德幸相期坐小子风中一月	耳顺从心无止境祝先生杖履千春
从幼年壮年至晚年学期随日月并进	修体育智育及德育人寿与天地同参
女界仰师宗胸贮钳珠咏絮清才传早岁	遐龄添寿算手牵彩帨称觥乐事庆长春
有令子名重儒林菽水承欢庭前多种忘忧草	惟贤母望孚慈壶华堂晋祝发上新簪益寿花
纱幔乐薰陶共钦巾帼名师教育扩充光女界	璇闺添帨豫长驻蓬壶丽景期颐迭晋祝龟龄
拜手仰慈云谂知鸿案多情春永兰闺添乐事	倾心承化雨省识鳣堂溢喜日长蓬岛祝遐龄
威名高北斗	勋业寿南山
勋章耀文虎	老子其犹龙
将军称大树	元老祝长春
帐上祝九五福寿	胸中具十万甲兵
萱室春长莱衣献舞	柳营秋爽桃宴胪欢
狨座扬威勋昭日月	鹤寿添算福享春秋
威镇边庭勋业重	功铭钟鼎寿龄高
君子万年诗歌锡类	健儿百辈朋酒胪欢
龙马精神威扬海甸	岳嵩钟毓秀挺蓬莱
早岁请长缨果然功立	良辰酌大计允矣年高
开府建年朔方节度使	延年益寿南极老人星
陈洪范九五福	祝生佛亿万家
庆治悬弧娱晚景	恩周挟纩驻春晖
自是君身有仙骨	无如尊贵又长生
海宁尘清资上略	蓬山春暖护长春
经济匡时昭一代	功名寿世足千秋
窦桂流芳鲤庭遵训	乔松进祝鹤算添筹
东社耆英欢国嘉会	平泉花木怡养暮年
官府即神仙饲鹤调琴培寿脉	叟童齐鼓舞扶鸠骑竹庆生辰
禄养慈亲金章耀彩	荣褒寿母锦帨腾辉
德政播四方常与斯民造福	颂声盈万户共祝使君延年
勋名富贵特萃一身立言立功先在立德	经济文章不分两事寿国寿世尤宜寿民
策杖扶鸠善人征寿相	调琴饲鹤仙署驻长春
医国医人同兹医意	寿民寿世亦以寿身
戏习华伦禽医国医民宏胞与	觥称豳俗兕寿人寿已乐康强
药回生香别有壶中日月	芝田纪算俨然世上神仙
科学专家刀圭巧擅西欧术	仁心济世寿算明添南极星
画与书皆妙	寿同福并高
翰墨春光耀寿域	丹青异彩入霞觞
银汉图成富贵寿考	香山绘就神仙耆英
艺名高北斗	琴韵颂南山
气吐烟云情若水	胸藏家国寿如山
气吐烟云情怡山水	胸藏丘壑寿祝冈陵
婉啭歌喉麻姑献寿	翩跹舞袖天女散花
词苑诗坛大手笔	鹿骑鹤驾老寿星
钟鼎名山八分垂露	文章寿世十牒屏风
斗酒百吟诗人高寿	奇文十卷墨客遐龄
戏剧作千秋宝鉴	史传读五代伶官
帖写换鹅书名传世	文成舞鹤寿算添筹
流水高山琴声养性	珠徽玉柱彩舞承欢
下棋悟玄机河洛探源推国手	长庚耀瑞彩星辰布局识大心
慈惠常留众口颂	典型堪作后人师
同向甘棠挥雨泪	难将寸草报春晖
想见音客空有泪	欲闻教训杳无声
空梁月冷人千古	华苑魂归鹤一声
九源有泪流知己	万户同声哭善人
慎终不忘先人志	追远常怀一片心
南极无辉寒北斗	西风失望病东人
雨霖舌蕊流红泪	雪压松枝着素装
未弭前思顿成永别	追录笑绪皆为悲端
魂归天上风云惨	名在人间草木香
壮怀犹在风云上	诗卷长留天地间
看水兴悲愁碧汉	望云垂泪染丹枫
山耸北郊埋硬骨	泽留乡里仰高风
云深竹径樽犹在	雪压芝田梦不回
泪添九曲黄河溢	恨压三峰华岳低
往日论交钦恕道	今朝追悼寄哀思
盛德合应传后世	遗形从此望前贤
福寿全归音容宛在	齿德兼隆名望常昭
良操美德千秋在	亮节高风万古存
人问未遂青云志	天上先成白玉楼
美德堪称吾辈典范	遗训长昭后世子孙
不成门户愧为子	难报春晖欲断肠
情深风木终天恸	泪点寒梅触景思
想见音容云万里	思听教诲月三更
音容宛在灵车驾	子女堂前血泪抛
千至吊君惟有泪	十年知己不因文
烟径云迷风凄翠柳	石阶露冷雨泣黄花
等闲暂别犹惊梦	此后何缘再晤言
白骨未归三尺土	忠魂已上九重天
群山披素玉梅含孝意	诸水鸣悲杨柳动伤情
勤劳美德愿儿孙永继	简朴家风望后代长传
生前忠节似松凌霜雪	身后高风如水照青天
多少人痛悼斯人难再得	千百世最伤此世不重来
少者亡老者存数诚难测	天之涯地之角情不可终
终身俭朴留典范	一世勤劳传佳风
明月清风怀入梦	残山余水读遗诗
平生风义兼师友	来世姻缘结弟兄
夏雨花残春已去	秋风月落夜难圆
秋草独寻人去后	家林只见日西斜
三更月冷鹃犹泣	万里云空鹤自飞
有子读书父不死	为人有用鬼亦英
一腔热血倾公务	两袖清风为人民
严亲已去恩未报	慈怀不留孝难行
膝下承欢未尽意	床前伺奉尚余心
山耸北郊埋忠骨	泽留乡里仰逸风
风凄瞑色愁杨柳	月吊宵声哭杜鹃
空梁月冷人千古	华表魂归鹤一声
死去原知千古恨	生来已作万年传
老泪无多哭知己	苍天有感泣斯人
兹竹当风空有影	晚萱经雨仍留芳
倚门人去三更月	柱杖儿悲五夜寒
秋水蒹葭溯往昔	春风桃李想恩人
英姿爽气归图画	丹心壮志遗儿孙
未弭前思顿成永别	追寻笑绪皆为悲端
美德常于人世里	英灵永在天地间
悲音难挽流云住	哭声相随野鹤飞
春光挑叶鸯啼湿	夜雨萤花蝶萝寒
可歌可泣勤风朴范	可哀可怜缩食节衣
梦断庚星韬光匿彩	心伤子夜返璞归真
著作名山与天同寿	感伤逝水厌世长辞
华表千秋精灵宛在	名山一卷著述长留
人到盖棺方有定论	我将碎琴以报知音
日月驶如流一朝永诀	风云诚不测千古同哀
多少人痛悼期人难再得	千百世最伤此世不重来
寿越七旬睦邻精神今犹在	含笑九泉勤俭作风永世传
契合拟金兰情怀旧雨	飘零悲玉树泪洒凄凉
鞠躬尽瘁寸心不感尤不愧	光明磊落一生无谄也无骄
青山绿水长留生前浩气	苍松翠柏堪慰逝后英灵
风云忽变天愁地哀无日暖	松竹猝折山悲水怨剩月寒
德重如山寸草春晖难报德	恩深似海空庭月夜痛思恩
齿德俱尊犹执谦恭敦族谊	形神虽逝尚留清白著乡评
烟雨凄迷万里红花洒血泪	音容寂寞千条流水放悲声
跨鹤孤山三十载梅花一梦	骑鲸采石五百年明月重圆
天若有情应寿百年于俊杰	人谁不死独将千古让英雄
大雅云云绿水青山谁作主	老成凋谢落花啼鸟总伤神
大雅云亡绿水青山叙遗志	老成凋谢落花啼鸟总伤情
残月冷空山群谷已随黄石去	寒云低野渡束刍空怅素车来
规律难违自古谁能千年寿	高风永继而今人仰一世功
道其犹龙呼剑水云横嗟去渺	翁今化鹤矣花庭月暗恨归迟
撒手了无难尘世长辞归碧落	伤心将大用夕阳虽好近黄昏
樽酒昔言欢，烛剪西窗，犹忆风姿磊落	人琴今已杳，梅残东阁，只余月影横斜
慧业几生修，梅瘦冰清，如此多才胡不寿	故人双泪下，枫青月落，纵交入梦也吞声
故旧情深，忆白发青灯，围炉曾共谈家事	秋风萧瑟，对丹枫黄菊，登堂同悼老成人
心流碧血	恨断黄泉
灵前泪雨洒	堂上儿孙泣
哭灵心欲碎	弹泪眼将枯
凄风洒地	抱恨终天
伤心成永诀	挥泪泣慈亲
生死情难舍	阴阳路已分
赴青帝约	跨白鹤归
风凄三楚地	云暗半边天
正气传千古	忠魂上九霄
素横银汉	泪洒黄花
半天星遽陨	三伏气犹寒
灵外奠云聚	堂中悼念多
一人离世	四代同悲
朔风椿树折	残月梓株寒
寿终德望在	身去音客存
音容已杳	德泽犹存
桃花泣血泪	柳叶锁愁眉
恨地憎天泣血泪	捶胸跺足放悲声
灵前飞烟雨	堂上放悲歌
燕剪麻衣素	蛙敲丧鼓悲
乍闻噩耗肝肠断	每念深恩面貌归
一堂哀乐揪心肺	四面悲声孝子孙
万种愁肠数不尽	两眶血泪几时干
魂归天上风云暗	名在人间草木香
生前厚德心无愧	死后清名口有碑
慈惠高风垂万古	冰操懿范足千秋
山耸北郊埋白骨	泽留乡里仰英名
苍山有雨皆成泪	白水无波不载衰
何必生前门第贵	难求死后姓名香
自有芳馨留梓里	应无遗憾到泉台
万里云天悲落日	千行泪水洒长空
长著芳名于竹帛	永留清白在人间
月下双双流泪眼	灵前个个断肠人
把酒焚香而祭尊	长歌当哭以招魂
心中永念生前事	世上长留死后名
想见音客空有泪	欲闻教诲杳无声
有眼苍天同我哭	无情明月任它圆
生时磊落心无愧	去日坦然魂亦安
一世精神归梦地	满堂血泪洒云天
雨中竹叶含珠泪	雪里梅花戴素冠
苦雨凄风悲永决	寒天冷月悼孤魂
柳知孝意飞花白	鹃解哀情泣血红
一人眠目如灯灭	合族痛心似火烧
长著久名于竹帛	永留清白在人间
雪里梅花含孝意	水边金柳动哀情
想见亲容云万里	毋供菽水泪千行
难从言下闻遗训	敬向灵前献瓣香
流水夕阳千古恨	暮云春树一天愁
唢呐三声和泪去	悲歌一曲伴云归
诀别亲人常惦念	难逢知己更伤悲
悲声难挽流云住	泪雨相随野鹤飞
君去九泉容独在	友来三拜泪双流
雨淋紫竹垂红泪	雪压青松戴素冠
德厚业精光荣一世	福圆寿满安息九泉
死博千秋独有清辉留马帐	生悭一面惟余泪眼看羊碑
魂断今宵万里寒云增缟素	名留梓里一天悲泪洒青山
堂前悬遗像凝眸挥洒凄凉泪	室内响余音侧耳聆听教诲声
生于黑世苦矣叹操劳少食缺衣惊鹤唳	梦断黄梁福兮期久享伤心挥泪怕鹃啼
体驾一棺忽去也	魂升隔世曷来乎
劭德留乡里	仙魂赴九泉
身随棺木黄泉去	名与母仪盛世留
宁教难忘父教	安居牢记党恩
节日香灯施羹饭	平时泪眼望慈容
春复椿不复	岵存父何存
年年过节年年有	日日思亲日日无
父母音容常在梦	儿孙思念总萦怀
梦牵慈母手中线	针缝爱儿身上衣
守考不知冰雪冷	思亲倍感弟兄贤
春意难消萱阁冷	雪花骤落孝家哀
神州处处皆春色	懿母嗣嗣独素风
庭前春近疑无影	梦里云迷系所思
母往方壶千古乐	儿居家室百年哀
犹忆熊刃承母训	何从鸟喃报慈恩
梅花有意含珠泪	竹叶多情唱挽歌
思存杏雨烟笼月	念寄杨花絮漫天
桃花含笑垂红泪	柳叶凝烟锁翠眉
五福堂添子女泪	三多庭念父母恩
素纸写春联早知门外新春至	哀思驱岁月快告世间旧岁除
良操美德千秋在	亮节高风万古存
泪眼常濡春雨湿	愁容单逐白云飞
椿影已随残月去	桂香犹逐好风来
千山不语齐俯首	万水鸣咽共吹箫
万里云天归落日	一门雨泪洒麻衣
水流东去归大海	日转西沉思故人
兰亭少长悲陈迹	玉局风光叹化身
老泪无多哭知己	苍天何遽丧斯人
千卷史书怀拥座	一帘风雨忆篝灯
日落西山常见面	水流东海不回头
空梁月冷人千古	秋风桐叶一天愁
何如一梦飞蝴蝶	竟使千秋泣杜鹃
径扫丹枫皆丧礼	门临白马尽佳宾
翠色和云笼夜月	玉容带雨泣春风
龙隐海天云万里	鹤归华表月三更
白雪有情亦落泪	绿竹无语也含悲
春雨梨花千古恨	秋风桐叶一天愁
空山月冷人何在	幽宅风寒痛莫穷
玉树长埋悲老友	瑶花焕发盼佳儿
志同松柏清同竹	言可经纶行可师
蓬门日影高轩过	蒿里歌声白马来
扶桑此日骑鲸去	华表何年化鹤来
骑虬夜冷湖边月	驾鹤朝栖岭上云
白马素车愁入梦	青天碧海怅招魂
泪添九曲黄河溢	恨压三峰华岳低
风凄瞑色愁杨柳	月吊宵声哭杜鹃
朗月清风怀旧宇	残山剩水读遗诗
往日论交钦恕道	今朝追悼寄哀思
剑空宝匣龙应化	云锁丹心凤不来
九原有泪流知己	万户同声哭善人
绿水青山谁作主	落花啼鸟总伤神
云深竹径樽犹在	雪压芝田梦不回
一世精神归华表	满堂血泪飞云天
流水夕阳千古恨	秋霜春雨万人思
三月雨催椿树萎	五更风促杜鹃啼
流水夕阳千古恨	暮云春树一天愁
主业已归前辈录	典型留与后人模
桃花流水杳然去	明月清风何处寻
风吹秋水起珠浪	雨点春山满眼悲
看山兴悲愁碧汉	望月垂泪染丹枫
鹤驾已随云影杳	鹃声犹带月光寒
君子终日朝乾夕惕	先生之风山高水长
壶中日月三生梦	海上云山万里秋
鹤唳三更空月冷	鹃啼午夜咽风寒
人雅云亡空怀旧雨	哲人其萎怅望高风
夕阳流水千古恨	春露秋霜百年愁
雨入白山都是泪	云是黑纱总成愁
为人正直毕生无愧	办事公道浩气常存
三径寒松含露泣	半窗残竹带风号
风号夜树子规啼	雪扫重门白马咽
华表千秋精灵宛在	名山一卷著述长留
古同松柏清同竹	言可经纶行可师
风骨直超双鹤上	语音犹在五云中
三岛十洲神游天外	七贤九老名在人间
四壁萧然悲夜月	三更冷落悯春辉
翠色和云悲夜月	玉容带雨泣秋风
天故忌才谁能无恸	世方多难君曷云亡
秋草独寻人去后	寒林只见日斜时
回溯前尘情同骨肉	追怀往事痛断肝肠
海阔天空忽悲西去	乌啼月落犹望南归
流水夕阳千古恨	凄风苦雨漫天愁
大雅云亡风凄紫陌	哲人其萎雨泣青郊
南极星残徒陈椒酒	华堂日谈空进桃汤
英灵不泯化万里旌飙	忠魂长在育千尺奇松
多少人痛悼斯人难再得	千百世最伤此世不重来
风惨云凄对青灯而自苦	山颓木坏痛绛帐之空悬
少者亡老者存数诚难测	天之涯地之角情不可终
名标彤史范	望断白云乡
女星沉宝婺	仙驾返瑶池
落花春已去	残月夜难圆
日碧魂依蔓草	雪红泪洒桃花
白云悬影望	乌鸟切遐思
淑德标彤史	芳踪依云云
风木有遗恨	瞻依无尽时
户寂凄风冷	楼空苦雨寒
画荻踪难觅	扶桐泪欲倾
天下皆春色	吉门独素风
花为春寒泣	鸟因肠断哀
春雨梨花千古恨	秋风梧叶一天愁
倚门人去三更月	泣杖儿悲五夜寒
花落萱帏春去早	光寒婺宿夜来沉
慈竹当前空有影	莲花此日尚留香
芳草清幽香满院	凄风苦雨哀盈门
身似芳兰从此逝	心如皓月几时归
雨泣黄花应有恨	风凄翠竹更堪悲
幽兰仍觉遗风在	宿草何曾润雨干
懿德难忘流痛泪	慈恩未报统愁肠
忽报风凄三楚地	怕看云黯半边天
慈竹霜寒丹凤集	桐花香萎白云悬
魂归九天悲夜月	芳流百代忆春风
绮阁风凄伤鹤唳	瑶阶月冷泣鹃啼
画堂省识春风面	环宇空归月夜魂
案积靶香存手泽	庭余芝草见心田
花落胭脂春去早	魂销锦帐梦来惊
惠质兰姿归阆苑	琼林玉树绕阶庭
雨霖杏蕊流红泪	雪压松梢戴素冠
天台白楼归仙驾	亲情慈爱梦母回
画堂省识春风面	环珮空归月夜魂
西笠莲翻云流悲	北堂萱萎月哭寒
懿范永垂家国史	慈容犹绕子孙行
魂归九天悲夜月	芳流百代忆高风
菊径荒凉冥漠秋效悲雨泣	蓉城缥缈苍茫野陌帐风凄
南国化行长留懿范	北堂春去空仰慈颜
南浦羁愁明月梅花空有影	西池返驾凄风慈竹不容春
湘水曲终蓬山路杳	妆台生掩皓月雪封
梦断北堂春雨梨花千古恨	机悬东壁秋凤桐叶一天愁
菊径荒凉，买漠秋郊悲雨泣	蓉成缥缈，苍茫野陌帐风凄
冷月写凄凉响砌秋声听悲惨	慈云归缥缈空庭落月恨何如
百年能几许有守有为托燕翼	一笑竟长归无忧无虑赴龙华
辞尘祖去空留像	投笔人回不见颜
一夜秋风狂摧祖竹	三更凉露泪洒孙兰
欲见严容何处觅	惟思良训弗能闻
祖父尘生音容犹在	嫡孙承垂日黯心痛
勤劳本质儿孙永记	革命家风世代不忘
风起云飞室内犹浮诫子语	月明日黯堂前似闻弄孙声
寂寞乾坤邈笑一公何所在	凄迷风雨哀哉两字弗堪闻
祖德本堪传，耕种书田，共荷谋贻燕翼	先芬徒泣诵，抚摩磐石，何以虑竭乌私
祖母仙游千栽去	诸孙泪洒何日干
抱孙昔日恩如海	承服今朝痛彻心
念祖母毕生操劳伤罔报	教孙曹终天抱恨痛难忘
慈训长昭谨守燕谋毋或失	深恩未报情陈乌哺永难忘
无病而终修是福	流泪不止悲为孙
美德常存天地间	嘉风久惠山河里
公颜自后从何视	善训而今总莫聆
想见尊空云万里	孙听训教月三更
福寿全归赓续诗歌绵祖德	音容忽敛叨陪杖履泣孙行
纵属铁石亦为洒泪	凡兹外孙怎不伤悲
厚谊附饴含从前雅嗜枣梨辱赐宠言蒙眷爱	深恩承岳戴此后傥闻丝竹缅怀往事益欷觑
宅相怀惭空忆音容符祖德	孙行忝附还将色笑慰娘恩
堪叹落花流水去	肯教明月送魂归
老母哭母痛泪难干	外孙如孙慈恩未报
鹤发龙钟王母胡为邀天上	桑田沧海神仙久住厌人间
萱幄喜长春视外孙如孙慈恩未报	莲台已仙去随老母哭母悲泪难干
泪血染成离落菊	悲肠裂碎砚池水
椿影已随云气散	鹤声犹带月光寒
如此韶华春犹未老	何来噩耗父竟云亡
流水夕阳千古恨	暮云春树一天愁
只见三秋多苦雨	谁知九月别严亲
春风有恨垂疏柳	晓露含愁看早梅
孝事伤心梅花欲白	啼痕泣血枫叶成丹
音容莫睹伤心难禁千行泪	亲恩未报哀痛不觉九回肠
亲厌尘纷寿终正寝归蓬岛	儿悲手泽眼流双泪滴麻衣
缺恨向谁言恨未胪欢承菽水	终天成永诀空余后悔断肝肠
空悬月冷人千古	华表魂归鹤一声
兰径水流三月暮	董帏花谢一庭春
怕看椒花含泪水	空闻萧鼓觅慈容
隔世欲望慈母影	三餐嚼碎赤子心
莫报春晖伤寸草	空余血泪泣萱花
惊春花染杜鹃血	倚门深得子规啼
倚阁风寒伤心鹤唳	兰台月冷陨涕萱阴
梦断北堂，春雨梨花千古恨	机悬东壁，秋风桐叶一天愁
九霄雪花，纷纷苍天表悲意	三溪流水，淙淙大地动哀情
德重如山，寸草春晖难报德	思深似海，空庭月夜痛思恩
老翁容貌不再见	小婿瞻仰竟无期
峰顶大人嗟已矣	膝前半子痛何如
恩同父称已随云影散	爱并儿号犹带月光寒
浮白自渐苏子美	垂青空忆李文公
丈人峰屺已作古	半子情灰念风范
半子情深诗礼训	三山迎杳海天秋
昔年樗质来龙谊邀半子	今日蓉城返驾情自含辛
公不少留风木伤心分半子	吾将安仰典型客欲问重泉
和凤寄高台雪冷椿庭忍听悲声翻玉管	骖鸾望古道月明苏馆不堪清影谢冰花
镜台前伤心徒洒千行泪	同堂上报德未伸半子心
忆半子昔日乘龙东床有幸	痛岳母今朝驾鹤北堂无依
凄凉甥馆慈云黯	缥缈仙乡夜月寒
莲蕊生香甥馆月	萱花遽谢佛堂云
自入婿乡蒙厚爱	何堪甥馆香慈云
莲蕊生香有子心中无限苦	萱花遽谢出人意外不胜悲
获迭昔乘龙独忆东床初坦腹	游仙今驾鹤那堪北堂杳慈颜
寿终德望犹在	人去徽音长存
红日难留暮景推思犹子	白云不返竹林事死如生
勤劳毕生侄儿表率	忠厚一世邻里楷模
想当年玉树交亲叨厚爱	痛此日竹林挥泪有余悲
化落竹林痛失慈萱去早	光寒婺宿悲兴犹子来沉
昔年训诲亲承犹子鲤庭聆教范	此日音容顿香儿曹马诚感遗书
痛伯母夏日炎炎伤驾鹤	叹侄辈夜悲耿耿泪啼鹃
扫榻飞烟惊化鹤	卷审留月伯母魂
魂归九天呼伯母	芳流百代忆高风
侄革分荣每祝萱堂多大寿	遗徽济美莫言葱肆少贤才
冥漠秋郊悲雨资冢母	苍茫野陌怅风协诸孤
勤俭持家半生最怜叔母苦	报酬天地六亲都为终世悲
昔年训诲亲承犹子鲤庭聆教范	此日音容顿渺儿曹马诫感遗书
一世辛勤范式乡里	终生节俭泽留村邻
叔父早魂飞梅岭云寒未知何年还鹤驭	侄儿常泪湿枫江月冷怕逢薄暮听乌啼
小子愧庸才平时杖履追随辄喜竹林叨训诲	吾家多旧德此后门庭辑睦永教棣萼入诗歌
幼侄无知想当年训诲谆谆眷顾深恩同无极	悲叔忽逝叹今日音容寂寂空瞻遗颜有余哀
勤俭持家半生最怜叔母苦	报酬天地六亲都为此儿悲
贤劳分得恩情乃犹子	缥缈更谁孤苦念零丁
幼年失恃仰荷慈云荻画著	远道相依遽歌薤露蓬山嗟
身逝音容宛在	风遗德业长存
一生俭朴留典范	半世勤劳遗嘉风
勤以持家善教子女生前诸事无荒废	乐于助人声闻村邻殁后何人不含悲
二竖膏育数月病魔唯一室	双行血泪所夭痛别永千秋
公何憾平生平肆志徜徉有先畴有旧业有祖功宗德独嗟参术无灵侵	姑其寡矣半世躬操井臼能茹苦能含辛能相夫教子怎那芙蓉开老洒
驾鹤西天去	留名人世间
谊属先姑光耀门楣叨慈荫	恩深犹子诗赓萝茑寄哀思
菱镜影孤哉惨听秋风吹落叶	锦机声寂矣愁看夜月照空帏
舅父楼月冷	处士里星沉
欲报母家厚望	难忘舅氏深情
风号夜树外甥啼	雪扫重门白马咽
此日舅父骑鲸去	何年形音化鹤来
豚犬惊号苦雨寒冰封泰水	瑶池竟赴辞尘弃世痛蒹葭
风悲三秋桂子香时舅已逝	泪凄九月菊花开后甥来迟
舅母似芳兰从此逝	甥儿如泪人绕愁肠
懿训昔难忘自顾庸愚惭宅相	慈容今顿杳甥未报答慰春晖
天台白楼归仙驾	慈爱舅娘三更梦
舅娘一去香无影	怜甥千声呼不回
兰摧工折舅母已去	花落水流外甥孤行
悼念不闻亲教诲	情怀仍忆旧音容
即谒高门早识邢谭通雅谊	来凭灵榇不堪萝茑失乔阴
儿孙称典范	邻里赞楷模
冷雨迫残春时节偏逢百五日	高风怀遗事音容遽渺九重泉
齿德兼尊犹执谦恭延后辈	典型俱在尚留声望启儿孙
小子有何知惟父母是依童年	亲情原最厚痛音容顿杳今日
音容宛在	懿德永昭
同行顿失慈容劳想像	教诲缅怀懿训寄悲哀
恩谊略同甥舅与吾母姊妹	往来天向邢谭惟小子童蒙
德才见诒谋有子能担家务事	荣哀酬生平伤心遽失老太公
文章留人世先生教子义方千古	劫后情热忱造就桑梓今失中坚
天不遗一老	人已足千秋
梁木忽崩折亲友衔哀长挥热泪	国事方倚重先生著述永垂美名
忽报风凄三秦地	怕看云暗半边天
哀乐寄哀思亲友共钦贤母德	遗容寓遗志子孙长念三春晖
月落杜陵屋	风凄董子帏
满圆禾苗伤化雨	一门桃李哭春风
大雅云亡风凄紫陌	哲人其萎雨泣青效
学子无师表	老成有典型
感旧有怀同向丽	招魂何处问巫阳
欲见严容何处觅	惟思良训弗能闻
一世深交堪难得	九泉有知念旧情
四海声名今北斗	百年文献老南村
慈惠常留众口颂	典型堪作后人师
西河留教泽	东壁陨文光
想见仪容空有影	欲闻教诲杳无声
筑师未能如子贡	心丧聊以学檀弓
当年幸立程门雪	此日空怀马怅风
培育桃李曾尽瘁	光辉竹帛永流芳
教育深恩终身感戴	浩然正气万古长存
此老竟萧条，幸有高文垂宇宙	平生怀大志，广栽桃李在人间
明月照寒窗，细检遗文长拭泪	子规啼午夜．重怀旧事倍伤神
生有自来死而后已	斯文未丧吾道益孤
好梦渺难寻	知音能有几
白雪阳春绝调竟成广陵散	高山流水伤心求断伯牙琴
教泽宏施忆昔年同沾化雨	音容顿隔痛此日空仰高山
一生献丹诚，南山松柏长苍翠	九天无遗憾，故园桃李已芳菲
菱镜影弧惨听秋风吹落叶	锦机声寂愁看夜月照空帏
不合时宜惟有朝云能识我	独弹古调每逢暮雨倍思亲
梦游蝴蝶飞双影	血泪杜鹃泣孤身
云深竹径樽犹在	雪压芝田梦不回
生前记得三冬暖	逝后思量六月寒
春江桃叶莺啼湿	夜雨梅花蝶梦寒
宝琴无声弦柱断	瑶台有月镜奁空
南极无辉寒北斗	西风失望痛东人
炊臼梦来哭尔三年发白	断机人去愁予五月枫青
一百年弹指光阴天胡此靳	九十载齐眉夫妇我独何堪
炊臼梦成粉悴脂憔金阁冷	断弦情切鸾孤凤只绣帏寒
一梦黄梁别儿离孙妻耶往矣	几搔皓首断柱破镜子也凄哉
负我多情空抱鸳鸯偕老愿	祝卿再世重旱鸾鸾未完盟
不作凡夫妻明年欲嫁今年死	愿为比翼鸟他生未卜此生休
恩爱良妻苦雨凄风催汝去	可怜儿女大啼小哭要娘回
数十年勤俭持家卿死料难如往日	恍然间今生永诀梦乡方能晤汝颜
淑德标彤史	芳踪依白云
苦我半生可怜举案荆妻先归天上	祝卿再世不遇登科夫婿莫到人间
落花春已去	残月夜难圆
缘尽先离伤心卅载荆钗慢说来生还有约	事多未了回首七旬椿树敢言已死便无知
窗竹鸣秋雨	床琴断夜弦
只望儿女成人生活日美你我同享快乐	不料人愿难遂好景不长夫妻从此东西
最怜儿女无知犹自枕畔娇啼问阿母重归何日	但愿苍穹有眼补此人间缺憾许良缘再结来生
你翁哀你姑哀你祖姑尤哀听盆鼓声喧一个个顿足捶胸看你如何舍得	我女幼我子幼我次子更幼到更阑人静皆依依牵衣问母教我怎样开销
碧水青山谁作主	落花遗霜总伤情
生前记得三冬暖	亡后思量六月寒
欲殉难抛黄口子	偷生勉事白头翁
鸾飞镜里悲孤影	凤立钗头叹只身
裂肺撕肝小寻老	捶胸跺足妻哭郎
鲲鹏音断云千里	杜鹃声哀月一轮
花为春寒泣	鸟因肠断哀
燕阵残斜孤月冷	箫声吹断白云愁
假如我死替你死	换来君生代吾生
无禄才郎长夜不醒蝴蝶梦	伤心少妇深宵悲听子规啼
郎果多情，楼上翼迎萧史凤	妻真薄命，冢前愿作舍人鸯
哭望天涯愿到黄泉痛洒大乔泪	恨如春水谁言世上惟独小青悲
数十年赤手起家你死料难如往日	八旬人白头永诀我生谅也不多时
生立奇功死留典范九泉瞑目君无憾	上侍高堂下抚子女一家重担我来挑
愁系竹林畔	泪弹荆树边
不图花萼终联集	何忍雁行各自飞
雁阵霜寒悲折翼	鸽原露冷痛孤翔
魂兮归来夜月楼台花萼影	行不得也楚天风雨鹧鸪声
云路仰天高谁使雁行分只影	风亭悲月冷忍教荆树萎连枝
原上春深鹊鸽音断云千里	林梢夜寂鸿雁声哀月一轮
训弟课儿一生辛苦今犹在	持身涉世十分忠厚古来稀
云路仰天高谁使雁行分棣萼	风亭悲月冷何堪鹤驭失葭莩
椿树萎经年方期棣萼敷荣争辉两阮	荆花摧往日谁料茱萸遍插又少一人
自愧不才此后议围难遽解	敢忘懿德于今家政复谁操
回想幼年时绕膝相依如我母	难疗今日病伤心何以慰吾兄
家事赖支持应知长嫂为娘一室不生轹釜怨	仙游伤仓卒忍听阿兄悼妇数声莫慰鼓盆悲
春草池塘犹入梦	秋风鸿雁不成行
一生辛苦今犹在	十分忠厚古来稀
棠棣联枝嗟失一	雁行折翼泣无全
归去来兮夜月楼台花萼影	行不得也暮天风雨鹧鸪声
云路仰天高谁使雁行分棣萼	风亭悲月冷何堪鹤驭失葭莩
竹径萧条平生壮志三更梦	云山迢递万里西风一雁哀
劲节励冰霜定卜泷冈终有表	衰年鲜兄弟可堪雷岸更无书
汝性最聪明曾伴阿兄吟柳絮	甥行皆幼弱忍看若辈著芦花
云路仰天高谁使雁行分只影	风亭悲月冷忍教荆树折连枝
同气遽分途原竟秋风魂还返	异时谁共被池塘春草梦难通
雁翼折西风先我而生乃遂先我而死	蛰音悲落日可叹在弟毕竟可叹在兄
谈笑一家中成咏雪诗当年才调原推尔	羁愁千里外登大雷岸此后音书待寄谁
亢宗惟盼见那堪一阵秋风鸿雁哀鸣悲折翼	传经常励弟回忆三年化雨鳣堂冷落最怆怀
相隔仅数里耳忆穷愁角酒谈笑论文话不尽黄卷青灯今兹已矣	作别竟千古耶叹游子浮云高堂日暮赋罢了绿波春草伤如之何
与我季共挽鹿车久传郝法	奈王母倏催鹤贺想伴荷仙
隔室惨难闻知是侄儿呼母哭	游仙魂不返忍看我弟悼亡诗
溯贤媛来自名门俭朴勤劳梁鸿妇	嗟予季悼伤佳偶凄凉呜咽鼓盆声
绮阁风寒我哭姐	瑶台月冷甥怨天
贞静幽娴姊妹行中推独冠	凄凉寂寞杜鹃声里暗伤神
鹤驾遽西归痛姊音容从此杳	雁行竟中断伤予手足何以堪
阿妹云古香茗已消空抱恨	沙哥未老浊茶虽寄亦无缘
宅相未离怀忍抛夫婿随姑去	诸昆幸无恙还期吾妹告亲知
月冷璇闺鸾音缥缈	风寒绮阁鹤泪凄情
人羡陆家姑万事补缝能爱弟	我仪张玄妹一时荣秀不留春
气谊洽醇醪忍使衰年悲北海	恩勤铭积悯不胜儿辈恸西州
从婿乡几度联欢异姓深情同手足	抚灵柩不堪洒泪空斋遗物感琴书
异姓亦弟兄甥馆联欢犹忆同寻春草梦	深情谐伉俪闺房絮语不堪重读大雷书
姻娅相关不殊兄弟	人天永隔空羡邢谭
两婿相关谓之娅平时贰室追随共说亲情	二姓好合其惟姻此后高门进谒空言戚谊
生前忠节松凌霜雪	死后高风水照青天
学术各门庭与子平生无唱和	交情同骨肉俾予后死独伤悲
六书渊源秦汉文字	一夕解脱神仙之人
时事伤心风号鹤唳人何处	哀情惨目月落乌啼霜满天
千里吊君惟有泪	十年知己不因文
犹似昨日共笑语	恍惚今时汝尚存
九原有泪流知己	万户同声哭好人
亲同手足此时杳无踪影	近伴春秋来日梦中相逢
小别遽招魂始信忧劳能损寿	高堂久忘世哪堪迟暮转摧心
松柏侣君一生错节风霜苦	同志爱我毕竟深情肝胆知
无缘话永诀知音来时泪泣血	有期解相思苍鸟啼处梦传神
廿载契何如犹觉兰言在耳	三秋悲永诀那堪楚些招魂
挂剑若为情黄菊花开人去后	思君在何处白杨秋浮月明时
梁木风摧从此不见尊君影	德星夜坠往后只看仙鹤飞
君竟永离故土含恨含悲今独去	我依活在此间常思常想再偕来
何处可招魂检箧尚遗玄草	为君欲挂到登堂空忆白云
管子天下才公论当年青史在	鲍叔知我者故交此日白头稀
君竟忘父母衰孱忍割尘缘骑鹤去	我但觉友朋寥落怕从天上识鸿归
丧贤妻固是人间哀痛事	想未来当也不必太悲伤
学伟人凡事心宽留取精神再奋斗	比先哲遇痛忍悲意在前途更争强
其夫贫而乐妇可知矣	有子贤且文母何恨欤
岁月无情鸳鸯折翼足令人肝肠痛断	事业有望骏马争奔抬望眼心胸放宽
自古志士当不为儿女温情贻误国事	而今我辈即便是恩爱齐眉亦应达观
千秋女学开蓝褛	一脉师承重典型
茗赋柳诗为同学冠	兰摧蕙折贻我辈忧
万卷诗书我还读	一时风月向谁谈
学富雕龙文修夭上	才雄倚马星殒人间
幸有高文垂宇宙	未酬壮志在中华
我辈读书正希望鹏程万里	他山攻玉忽惊闻鹤唳九皋
追往岁仙君与吾结笔砚之好寒窗共度	抚今日挚友向汝表手足之情悲泪独流
风片雨丝萧瑟忽摧女贞荫	莺啼燕语凄凉偏杂子规声
寥落数晨星鹤驾云中偏去远	凄凉忆旧雨蟀吟床下不成声
幸托丝罗荣分椿荫	悲歌蒿薤空奠椒浆
儿女亲事今世如意	两家结缘再生相逢
有弱女感姑恩为言辛苦持家十载伤心搔白发	最诸孤承父志会见联翩竟爽一门接踵到青云
玉树栽来欣擢秀	琼枝萎去动悲怀
亲同手足此时杳无踪影	近伴春秋来日梦中相逢
杨柳春风怀逸致	梨花寒食动哀思
六书渊源秦汉文字	一夕解脱神仙之人
睦邻精神今犹在	勤劳品质永留存
乡里称贤留有典型遗后世	近邻怀故收来秋色寄哀情
睦邻美德永留遗范	家室新风昭及后人
象应少微星彩落萧辰悲夜月	名登耆旧传芳流梓里忆春风
一世辛勤德留乡里	终生节俭和传院部
尔我结邻居友谊真诚逾手足	年时勤稼穑家声继起付儿曹
忆往昔家室萧条先无一旦之欢竞茹苦半世	看今朝门庭兴旺年逾八十而终当含笑九泉
月照寒枫空谷深山徒洒泪	霜封宿草素车白马更伤情
肃气苦相侵红树青山都惨淡	伤心来作吊素车白马剧悲哀
龙隐海天云万里	鹤归华表月三更
谁人无爱子心深情难自己	世上多指逆事永诀更何堪
花落萱帏春去早	光寒婺宿夜来沉
驾鹤方填天上人间悲恨别	骖鸾永逝金风玉露助凄伤
舅犹父也平时面命耳提总望成龙成凤	甥何丧乎此去人亡物在难免怨地怨天
快婿属南官迭获乘龙方谓于归欣得所	芳踪返西域魂随驾鹤更从何处赋游仙
云气初呵诗题桐叶庭除绿	天台永别泪染桃花洞口红
箧里诗书疑谢后	梦中风貌似潘前
一载卧沉疴李贺床头呼阿弥	十年问奇字杨云门下失候芭
人间未遂青云志	天上先成白玉楼
孔雀东南飞最是伤心同命鸟	鸳鸯左右顾不堪寒夜可怜虫
花落燕脂春去早	魂归鸳帐梦来惊
犹子比儿从来锦字成文淬掌居然呼不栉	浮生若梦此后玉台新咏招魂何处拾明珠
深痛昙花才一现	方知芝草木无根
往日列门塔最怜年少美才常指青云期远到	朔风吹噩耗顿触老人旧感重回白首忆前游
三年此日雨为泪	十月彼秋风欲悲
大恩何止三年祭	晚辈当存永志心
慈母别世痛三载	孝子哭灵裂五脏
爱儿辛勤苦一世	想父音容祭三秋
一世未终儿女情	三秋已过忆母恩
悼念先严三周年	痛表后生一片心
恨百草竟无救汝药	念一生常怀爱人心
慈心待人人尽怀念	良方济世世留芳名
医德高尚众口颂	药方神灵百疾除
以医活人而不计酬良相论功愧吾子	积德累世自然获报克家绳武在诸朗
著述有奇书仁术仁心操业岐黄传三世	针砭及世俗医人医国留名赤县自千秋
政绩今犹在	清名终古留
磊落英才冠时辈	欷觑太息动哀情
志壮情豪诚可敬	赤诚坦白留美名
哀歌动大地	浩气贯长空
正道至今犹在	清名终古常留
奋斗一生留业绩	激励后代展宏图
人间鸿羽折	天上大星沉
出生入死当年事	廉洁奉公此时心
有口皆碑留选誉	无言凝志寄哀思
单父焚琴七弦奇绝	河阳花瑟一县风凄
生为人民功高迹显	死于国事名垂千秋
为人正直毕生无愧	为事公道浩气长存
建设国家曾尽瘁	光辉竹帛水流芳
千行遍插来公竹	两泪同挥羊祐碑
驾返新城悲落日	名高故里仰遗风
平凡工作系千秋大业	高尚情操留万世芳名
奋斗为人民精神不死	光荣留青史百世流芳
生前忠节似松凌霜雪	死后高风如水照青天
沥血呕心革命精神足堪效	先人后己崇高品质诚可钦
爱党爱国爱集体精神永在	有德有功有美名风范长存
风风雨雨为人民终身奋斗	水水山山留足迹风范长存
鞠躬尽瘁一世无憾尤无愧	先明磊落终身不谄也不骄
魂魄托日月正气留千古	肝胆映河山丹心照万年
为国为民如此好官实难得	立功立德至今遗泽不能忘
世称奇男子	天丧真将军
于国有功真不世	为民捍患更何人
南征北战功不朽	春去秋来名永留
大树生前号	长城死后名
一生肝胆生无敌	百战威灵殁有神
羊祜惠犹留岘首	马援功未竟壶头
中天悬明月	前军落大星
南朔战功青史在	古今名将白头稀
故老掩涕三军凄感	中原极目千里丧春
星陨寒芒焰	风凄细柳营
大树高风万人敌	将军星陨一天寒
公有千秋名国有儒将	生为万人敌死为鬼雄
化鹤竞忘归华表高瞻霜月冷	屠龙空有技剑光犹带斗牛寒
天壤长城河山变色	功称大树风雨惊秋
铁券分封剑气当年横塞北	黄粱入梦将星一夜陨江南
如此乾坤得卧龙而后定	正当风雨失鸣难其奈何
天上大星沉万里云山同惨淡	人问寒雨迸三军笳鼓共悲哀
尽瘁鞠躬勿惊大将星初陨	出师丧志长使英雄泪沾襟
大将富韬铃满拟金饶同奏凯	中原失保障空留铜像特铭勋
有长者风无市侩气	离浊尘世登极乐天
公抱管鲍才正思我商有赖	世无扁苍术竟使厥疾不瘳
明哲云亡空怀端木	典型足式怅望陶朱
贸易久孚回首杜梁瞻落月	老成遽之伤心鲁殿圮灵光
感旧有怀同向秀	招魂何处失陶朱
直道至今孚市井	旧游何处感邻家
忠厚成心市井咸钦盛德	音容隔世经营空惜长才
未竟厥施公为创业兴商祖	倏然待尽我亦浮家蹈海人
台德兼尊犹执谦恭延后辈	典型具在尚留声望属商家
致富万金为实业界中泰山北斗	斯人千古是货殖传上端木陶朱
劳苦辛勤生平瘁体力	箕裘弓冶后起振家声
熟读考工记，一篇不愧宗师称大匠	深感老成人，千古空教后辈仰遗型
大笔淋漓坊者传	劳工神圣寿而康
劳工神圣尽其天职	老城典型犹在人间
上寿七旬从心不逾距	斯人千古劳力以终身
痛失慈亲举家悲戚	长留懿德全材缅怀
乡里称贤，留有典型遗后世	丰收在望，忽惊溘逝别人寰
墨云香冷来琴馆	薤露寒生赋鹏文
工精艺巧堪称妙手	赤胆忠心一片真诚
壮怀犹在风云上	诗卷长留天地间
文章卓荦生无敌	风骨精灵殁有神
累年陋室相随泼墨手书师弟交情如骨肉	此后吾庐谁主隔江挥泪梦魂终古恋湖山
功名事业文章他生未卜	嬉笑悲歌怒骂到此皆休
一死便成大自在	他生须略减聪明
既死莫伤心好料理身后事宜莫弄得七颠八倒	再来还是我且撇下生前眷属重去寻六故三亲
五千里北辙南辕看人富贵受人怜落拓穷途何处洒狂生泣泪	十一次东涂西抹呕我心肝催我命仓皇岐路再休提名士风流
生当作人杰	死亦为鬼雄
正倚济时唐李郭	竟嗟无命汉关张
未酬壮志身先死	留取丹心照汗青
铁肩担道义	热血荐轩辕
生经白刃方为贵	死葬红花骨亦香
日月行天忠烈芳留百世	江河流地英雄功存千秋
英灵昭日月	肝胆映山河
先烈精神在	英灵浩气存
平生慷慨班都护	万里间关马伏波
我公曾有言，不拼却好头卢曷为男子	国人须记取，愿相爱如手足以报将军
功德无量	青史永垂
江河呜咽	草木含悲
伟业秀千古	英名在人间
大功垂宇宙鞠躬革命	讣电震环球举国伤心
恩泽四海	功高九天
悲歌动地	哀乐撼天
化悲痛为力量	继遗志写春秋
忠魂一缕萦萦依故土	正气无量浩浩满中华
已有丰功垂青史	犹存大节誉人民
功业常齐天地永	红旗自有后人擎
革命者大名垂宇宙	八宝山烈焰照山河
功德常与天地在	英名永垂宇宙间
山河共存音容在	日月同辉伟业新
功著神州音容宛在	名垂青史恩泽长存
惊回首伟业丰功垂宇宙	抬望眼高风亮节勖人民
五洲共仰覆地翻天开国运	四海同悲竭志尽瘁为人民
追忆逝者缅怀前辈创业	悼念伟人勉励后代接班
举国同悲忠心赤胆兴邦手	永年不朽伟业丰功革命家
慎终须尽三年礼	追远常怀一片心
门出高仙骑龙背	石雕群兽壮虎威
玉树芳兰承俎豆	金章紫诰答蒸尝
山迎水送	虎伏龙蟠
龙虎之地	福祥之天
含笑九泉下	还家五夜中
先人德望在	后辈业绩高
依山傍水大福地	步云攀桂有缘门
祖德无穷千秋常祀典	儿孙百代万古绍书香
一门忠气山河壮	百代精神日月光
祖功宗德流芳远	子孝孙贤世泽长
福田宗祖种	心地子孙耕
礼乐绳其祖武	诗书贻厥孙谋
百代孝慈山仰泰	万年支派水流东
俨若思教孙有庆	祭如在明德惟馨
春秋匪懈	继序不忘
典祀千年重	绵延百世昌
英声振百世	清誉垂千秋
祖功垂福泽	宗德衍家声
昭假烈祖	佑启后人
宗祖规模远	儿孙绍述长
四镇多二心，两岛屯师，敢向东南争半壁	谁人抒国难，一隅抗志，方知海外有孤忠
感恩知己两兼之，拟今春重谒门庭，谁知一纸音书，竟成绝笔	尽忠补过久已矣，忆平昔双修儒佛，但计卅年官绩，也合升天
江户失丹忱感君首赞同盟会	轩亭流碧血愧我今招侠女魂
英雄做事无他，只坚忍一心，能成世界能成我	自古成功有几？正疮痍满目，半哭苍生半哭公
惊座文章传四海	新民德业播千秋
长庚陨落，敌友同惊，辍会衔哀旗半降	泰岳崩摧，华洋共恸，群音遇密泪横垂
仗剑从云，作千诚忠心不易。军声在涯海，遗爱在江南，万庶尽含哀，四望大好山河，永离赤县	挥戈挽日，结尊俎豪气犹存。无愧于平生，有功于天下，九泉应含笑，伫见重新世界，遍树红旗
乐府近凋零，学就成连人已逝	吹台遥怅望，化为精卫客应归
叹息浮生同落叶	本来才调是飞仙
两卷新诗，廿年老友，相逢日星天涯，只为佳人难再得	一声河满，九点齐烟，化鹤重归华表，应愁高处不胜寒
巨笔写春秋，何独屈子问天，文姬归汉	雄才跨百代，岂让杜陵尊圣，太白称仙
多少前尘成噩梦，五载哀欢，匆匆永诀，天道复奚论，欲死未能因母老	万千别恨向谁言，一身愁病，渺渺离魂，人间应不久，遗文编就答君心
悼一代巨星殒落，举世无限伤感	幸满台桃李新生，梅艺万古长青
常恨随陆无武，绛灌无文，纵九等论交到古人，此才不易	试问夷惠谁贤，彭殇谁寿，只十载同盟有今日，死后何堪
将略冠国门，日寇几回遭重创	英雄羁缅境，国人无处不哀思
保障共和，应与松坡同不朽	宣传欧化，不因南海让当仁
方悬四月，叠坠双星，东亚西欧同殒词	钦诵二心，憾无一面，南天北地遍招魂
孔子之前，无一孔子；孔子之后，无数孔子	鲁迅之前，无一鲁迅；鲁迅之后，无数鲁迅
魂魄异乡归，于今豪杰为神，万里河山皆雨泣	东南民力尽，太息疮痍满目，当时成败已沧桑
侠骨柔肠，横眉俯首	胸中海岳，笔底风雪
血溅金沙，允有大名光宇宙	魂招歇浦，愧无钜笔志功勋
瀛谈百代传邹子	信史千秋哭贾生
贻我一篇书，语重心长，自探立国千年奥	奠君三爵酒，形疏礼薄，难写回肠九曲深
一战一和，当年变生瞬间，可大白于天下	再接再励，后起大有人在，应无忧乎九泉
为革命而奋斗，为革命而牺牲，死固无恨；	在压迫下生活，在压迫下呻吟，生者何堪！
要打叭儿落水狗，临死也不宽恕，懂得进退攻守，岂仅文坛闯将？	莫作空头文学家，一生最恨帮闲，敢于嬉笑怒骂，不愧思想权威。
灰撒江河，看不尽波涛，涓滴都是人民泪	志华日月，信无际光焰，浩气长贯神州天
积毁铸沉冤，十年风雨燕山夜	丹心同皎日，千古昭垂赤县天
著作最谨严，非徒中国小说史	遣言太沉痛，莫作空头文学家
七十二健儿，酣战春云湛碧血	四百兆国子，愁看秋雨湿黄花
树欲宁而风不静，子欲养而亲不待，奉母百年岂足？哀哉数朝卧病，何意撒手竟长逝？只享春秋六二	爱国壮志尚未酬，育我身矣恩未报，愧儿七尺微躯，幸也他日流芳，应是慈容无再见，难寻瑶岛三千
老臣白发，痛矣骑箕，整顿乾坤事初了	满眼苍生，凄然流涕，绯徊门馆我如何
夫妻恩，今世未全来世再	儿女债，两人共负一人完
山海风波，心盟永忆	万家恨雪，去际长明
向阳庭院风光好	勤劳人家幸福多
宏图大展兴隆宅	泰运长临富裕家
红日洒辉临吉宅	春风送暖入华堂
日丽新居暖	风和甲第安
祥云环绕新门第	红日光临喜人家
春风杨柳鸣金星	晴雪梅花照玉堂
家种吉祥草	宅开幸福门
一片彩霞迎旭日	满门春讯庆新居
择居仁里和为贵	善与人同德有邻
新屋造就千般喜	满室和睦百事兴
日照新居添锦绣	花栽院圃吐芬芳
吉星高照	福地呈祥
天眼照宅地	阳光撑栋梁
竖柱逢吉日	上梁遇良辰
画锦来三凤	奎光聚八龙
旭日悬顶	紫薇绕梁
金梁光耀日	玉柱力擎天
青龙缠玉柱	白虎架金梁
堃正奠新业	基实撑大梁
夯基符地利	上梁合天时
吉星照佳地	紫气拂新梁
龙腾日有吉	凤舞云呈祥
忠诚作柱石	耿直为栋梁
花开富贵人开眼	日上中天屋上梁
紫薇高接三台瑞	室砌祥辉五色云
喜竹苞永茂	庆磐石长安
宝盖呈祥香结彩	银台报吉烛生花
栋拂云霞绕紫气	家传浩气足春风
定磉欣逢大好日	上梁正遇幸运时
今日玉柱根基固	明朝新房喜庆多
云栋尽书金碧宇	瑶阶并种吉祥花
吉日立柱凝百瑞	良辰上梁集千祥
金梁灿灿光耀日	玉柱巍巍力擎天
家业振兴凭双手	栋梁凌空靠齐心
堂构宏开锦世德	规模丕振启人文
基实奠定千秋业	柱正撑起万载梁
栋起祥云连北斗	堂开瑞气焕春光
成家全凭劳动手	筑屋尽是栋梁材
负重全凭基础力	擎高端赖栋梁功
日升月恒天赐百福	竹苞松茂地发千祥
择地适逢中兴日	上梁正值丰收年
千秋事业原非易	万代根基由来深
兰桂联芳祥呈胜地	椿萱并藏吉溢高堂
祥云捧日日吉利	瑞气盈门门盛昌
旧时燕垒初更换	今日鸿基已奠成
千秋家业有巧手	百代栋梁用铁肩
玉柱功撑蓬勃丰采	金梁高架潇洒新姿
吉日甚吉大梁宜举	良辰毕良根基因坚
架金梁广获亲朋助力	立玉柱多谢戚友帮忙
大地灵钟肇成文明之运	华堂瑞霭弘开富贵之基
山环水绕	人杰地灵
祥麟臻圃	鸣凤栖梧
栋宇朝红日	竹帘引惠风
虎踞龙蟠地	夏凉冬暖家
物华焕彩	天宝呈祥
瑞霭住地	福蕴新居
新基欣奠定	宏运启文明
南山户对开黄道	北阙门迎照紫薇
堂构森严绳祖武	天葩彩发焕人文
日月耀辉光画栋	山川秀丽映雕栏
五柳尽称陶令宅	百花新构杜陵庄
江山聚秀归新宇	日月新辉映华堂
华构落成千年计	小筑安居四时春
承家事业辉堂构	经世文章裕栋梁
碧宇倚云昭大壮	紫薇映日焕中孚
山水朝宗依旧日	堂前集瑞霭新居
堂构初成千载业	垣墉已筑万年基
门外青山水流秀	户内人旺财源兴
竹苞秀起云为屋	兰玉香生锦作堂
华堂建就六亲为	玉宇落成百匠功
兰室犹然仍旧址	槐堂又喜庆新居
甲第鼎新容驷马	华堂钟秀毓人龙
桂馥兰馨子孙永保	竹苞松茂天地皆春
累仁积德根基厚	对宇望衡光景新
甲第宏开肯堂肯构	壬林献颂美奂美轮
映日红标五色云中飞彩凤	凌霄画栋万花丛里耸虬龙
居华屋着新装饮美酒止不住笑笑笑	思变革创大业瞻前程只觉得甜甜甜
堂连绿野	室接青云
玉堂映昼锦	华屋霭春晖
庭外遍山绿	室内满堂红
喜红光四照	看气象一新
吉星高照	幸福常来
禧凝燕贺	庆肇鸿图
两双勤劳手	一栋砖瓦房
政通千家福	人和万户欢
一家和气	四壁春风
家蕴五福	院蔼三春
吉门沾泰早	和里得春多
庭辉联树彩	檐影接云光
全家福气	满院春光
文明昌景远	栋宇绕彤云
花开家富贵	竹报人平安
家和人益寿	睦邻门满福
春安夏泰	秋吉冬祥
东风开画栋	旭日映华堂
茂林莺语闹	新屋燕声喧
祥云生紫户	喜气绕朱轩
溪山呈瑞彩	庭砌焕祥光
肇启文明运	宏开富贵基
新春迁新宅	福地启福门
庭院花香鸟语	楼台月满云开
景美年丰家瑞	日丽岁安人欢
云接画檐流宝气	日临丹室尽春光
华堂昼永书香满	乔木春深雨润多
勤劳方致富	和睦可生财
鹤舞千年树	凤鸣百尺楼
三阳临地家吉	五福映门人昌
祖国和风日丽	家人喜地欢天
子孙兴旺千般喜	家庭和睦万事兴
欣逢盛世迁乔第	喜值丰年进雅居
一家欢笑春风暖	四季平安淑景新
三阳日照平安宅	五福星临吉庆门
五色祥云笼甲第	三年福景聚新门
忠厚一生期祸少	平安二字更值多
小宅更新承党荫	阖家温暖叙天伦
民重农田能治国	光增新宅喜齐家
居卜风和仁是里	堂开景聚德为邻
门对青山摇钱树	户迎绿水聚宝盆
房倚青山添景色	门临绿水好风光
祥和一家生百福	孝贤二字值千金
门外青山水流秀	户内人旺财源兴
近水楼台先得月	向阳花木早逢春
昔日茅棚随流水	今朝瓦屋伴高山
家过小康欢乐日	人迎大地艳阳天
倚山背绿添新宇	语燕啼莺人世家
莺迁华屋春日照	燕贺雅室福星明
和气频添父母寿	祥风常伴子孙福
春风化雨艳桃李	瑞霭盈屋旺子孙
日丽风和锦铺院	冬暖夏爽笑满堂
家随芳草千年艳	人与梅花一样清
清风流水当门转	春暖飞花隔岸来
旭日乍临家室乐	和风初度物华新
新居落成三代喜	全家和睦万般兴
乔迁美厅步步起	喜居层楼阶阶升
国运昌隆逢盛世	家庭和睦乐天伦
家有和气人有德	福临阶台喜临门
新地新居新气象	好山好水好风光
起屋开基百年大计	兴家立业五世其昌
瑞彩盈庭山聚秀	祥光当户斗联辉
福寿双全合家乐	吉祥如意喜盈门
生气盎然勤劳致富	竹林繁茂珠宇增辉
庭前细雨东坡竹	池上清风茂叔莲
瑞映画堂多喜色	吉临新宅焕春光
合天时祥云连画栋	得地利峻岭对新庭
春华秋实盈庭灿	桂馥兰馨易地荣
大哉居乎移气移体	慎其独也润屋润身
喜建华堂春风入座	乔迁新屋佳客盈门
华堂入云江山添一景	大厦落成农家乐三春
翠竹绕新构风景这边独好	红花香院宅江山如此多娇
建屋辟园景色美如画	兴家创业生活甜似蜜
兴大厦建乐园景色美如画	住新屋创家业生活似蜜甜
何必金屋玉堂方称杰构	就此简室寒舍便是安居
祥云统吉宅家承沾世添福祉	瑞霭盈芳庭人值半年增寿康
大地灵钟肇成文明之运	华堂瑞霭弘开富贵宏基
人勤地好画栋拂云联旧垒	春映花红玉兰绕阶缀新枝
砌铜墙粉铁壁华居添彩	上金梁竖玉柱庭宇生辉
山河发奇观新凤金龙旋地轴	庭阶生瑞气玉兰宝树茁天葩
庭前风光绚丽览四时美景桂香兰翠	屋后莺语婉转听几声歌唱心旷神怡
斗室前朝笔架高峰地势钟灵预卜财源广进	新居后倚文头大岭天然毓秀定占瑞气长来
屋洁何须大	花香不在多
红杏枝头春气闲	绿杨烟外晓寒轻
庭院中花香鸟语	楼台前月满云开
红砖青瓦	绿竹斜阳
玉柱擎红日	金舆入紫薇
玳梁欣贺燕	乔木早鸣莺
万里风云骐骥足	百年珠树凤凰多
宝树庭深花锦簇	莺声婉转韵调琴
帘前燕子和云剪	砌上桃花向日娇
门对青山庭铺芳草	屋临绿水窗横绿梅
栋宇嵯峨光凌彩凤天边日	规模壮丽秀掇金鳌海上春
喜临华堂瑞气缭绕百事顺	乐居新屋祥光普照万代昌
杰地仍幽水如碧玉山如黛	新居不俗凤有高梧鹤有松
德门集庆	仁宅迎祥
文章华国	诗礼传家
天开化宇	人在春台
瑞日开昌远	春风酿太和
祥光满室	瑞气盈门
门墙多古意	家世重儒风
华屋辉生壁	春山绿到门
院有山林乐	人同天地春
厚德载福	和气致祥
有容乃大	无我为公
依和成里	与德为邻
德六膺厚福	仁里乐长春
座有谈经客	门多问字车
门对千颗竹	家藏万卷书
扫径待延容	闭门思读书
书香透梅蕊	竹韵偕春风
家庭增幸福	时世乐昌期
忠厚传家久	诗书继世长
云霓笼甲第	气运耀门庭
湖山数峰壁	花柳五州春
珠藏泽自媚	玉韫山含辉
竹屋只堪君子住	紫门不为俗人开
一帘梅雨紫烟外	十里松风碧峰连
竹柏门庭喜	田园气味长
舍南舍北皆春水	村后村前多好山
风清流水当门转	春暖飞花隔岸来
有竹有梅门第	半材半郭人家
岂有文章惊海内	漫劳车马驻江干
门有古松庭无乱石	秋宜明月春则和风
郭外青山环抱	门前绿水萦回
春涵瑞霭笼仁里	日拥祥云护德门
九穗嘉禾征国瑞	几株丹桂振家声
秋雨梧桐院落	春风桃李门第
古画清香长天大日	名师益友盛业高文
试看题字疑为凤	敢道登门便是龙
天上碧桃和露种	门前绿柳受风多
诗书好画蔚家室	松竹梅兰镶门庭
流莺比邻如有佳语	睛雪满竹冷热希音
丹桂有根独长诗书门第	黄金无种偏生勤俭人家
进阶纳阶	入室升堂
春融大地	气霭重门
春风开甲第	瑞霭集重门
燕报重门喜	莺歌大地春
居仁由义	履中蹈和
重门凝瑞	深宅含辉
映曰辉生室	重花静掩门
青庭留紫照	朱户映丹霞
三阳临福地	五福萃重门
重门柳色连金谷	深院花香绕玉堂
一室生春周旅中礼	重门有喜迎送如仪
上苑梅花早	重门柳色新
鸟过重门多好语	花飞满坐有清香
香生小苑梅花放	翠掩重门燕子闲
品峻山崇守廉冰洁	德涵玉润知美珠圆
玉粹金和浑然元气	礼耕义种必有丰年
秋菊春兰晚香馥若	商彝夏鼎古意盎然
玉质金相当时之宝	颂经风纬冠世福华
常将令德表此风俗	不以外物扰其中和
慈孝友恭家庭礼乐	烟霞山水今古文章
玉树临风冰壶映月	芝畦养并桂畹翔华
庭院暖风池塘微雨	桃花春岸杨柳画桥
同轨同文遭际盛世	有物有则楷模古人
居以志养仕以禄养	德为人师学为经师
玉振金声子时为瑞	和风甘雨惟世之祥
所谓成人粹然至善	夫惟大雅卓尔不群
克俭克勤，保世以滋大	是彝是训，进德于无疆
地价不妨多，明月清风本无价	物情何足效，近水造山俱有情
轻烟芳草地	微雨杏花天
长化以行文为乐	太白非饮酒不仙
术业宜从勤学起	韶华不为少年留
天高飞紫燕	地厚栽阳春
书从疑处翻成语	文到穷时自有神
山增翠色饰氓阁	日洒金辉镀栋梁
程远飞驰马	志高舞强龙
名画要如诗句读	古琴兼作水声听
阳春有脚舒柳叶	淑气无边到梅花
心收静里雪真乐	眼放长空得大观
人能知足斯恒足	我爱得闲且少闲
闲从世外观今古	懒向人间问是非
有子才如不羁马	知君心似后凋松
岂有文章惊海人	从无书札到公卿
学浅自知能事少	礼疏常学慢人多
几番琢磨方成器	十载耕耘自见功
花迎喜气皆为笑	鸟语欢声亦解歌
得好友来如对月	有奇书读胜看花
一室风和可与竹	万年气静大年文
春风有形在流水	古贤寄迹于斯文
一庭之内有至乐	六经以外无奇书
水如碧玉山如黛	诗满红笺月满庭
闲裁蕉叶题唐句	细嚼梅花读汉书
窗临水曲琴书润	人读花间字句香
名花照眼春光满	奇句开天妙论高
风日一庭为良友	诗书半榻是严师
春风南国来新燕	旭日东升起大鹏
龙游鹿洞青云绕	鲸跃鹅湖紫气腾
墨花点笔浓云墨	瑶草入帘春雨香
真读书人天下少	不如意事古为多
诗情画意妆春色	燕语莺歌颂华年
诗经千载经纶事	松竹四时潇洒心
非因果报方行善	岂为功名始读书
不除庭草留生意	爱养盆鱼识化机
表随柳叶三分翠	人与梅花一样清
脱俗书成一家法	写生卷有四时春
山花烂漫	翠鸟啼鸣
春晚绿野秀	岩高白云流
顶风傲雪苍松劲	沐雨经风翠柏葱
丹凤迎旭	黄莺唱春
鸡催万里晓	春启千家门
鹏程万里前程远	虎震群山雄风光
云山风度	松柏精神
白云怡意	清泉洗心
谷静泉逾响	山深日易斜
厨里菜肴皆可口	房中食品尽芬芳
一粥一饭需珍惜	寸木寸薪当节约
柴米油盐品不少	甜香酸辣味俱全
烹调有术	饮食长宜
三餐味美	四季安康
勺炒五味鲜	油滴一点香
凡火烹五味	仙人下九霄
梅香入梦	竹影横窗
风清杨柳梦	月淡海棠红
临水看云去	钩帘待月来
窗前留夕照	月出映秋霜
夕阳多窗多画意	春雨一帘满诗情
池上水光开镜浪	庭前草色映帘波
床前常洒云水月	阶下漫奏溪石琴
秋露滋丹桂	春风醒碧桃
月影窗前静	琴声梦里清
松柏老而健	芝兰清且香
树影横窗知月上	花香入梦潜风吹
斗室乾坤大	寸心天地宽
倚窗明皓月	临枕清竹风
画阁和风暖	深闺化日长
竹影横窗花香人	春光交梦月明心
海内存知己	天涯若比邻
清言宣至理	正义发高文
雅量涵高远	昂扬论时风
清风留客醉	皓月伴诗吟
倾壶待容花开后	同心吟诗月上初
一庭花发来知己	百卷书开见古人
人间岁月闲难得	天下知交老更深
雅琴飞白雪	高论横青山
容雅花共诗	月清人同明
佳气生朝夕	清言见古今
爱客襟怀朋满座	照人肝胆月盈庭
读书满座风云气	论语一堂富贵春
佳友来时八座满	至理悟到三更明
静时疑水近	高处见山多
树影不随明月来	荷香时与好风来
月门含笑迎游客	池水溅花破霞云
芳草斜阳外	落花流水间
素艳雪凝树	清香风满枝
绿沼看鱼乐	青云羡鸟飞
柳占三春色	荷香四座风
柳絮池塘淡淡风	梨花院落溶溶月
有月而登台无论春秋冬夏	是风皆入座不分南北东西
静者心多妙	飘然思不群
户外千峰秀	窗前万木低
石榻看云坐	溪窗听雨眠
面山如对画	留客拥弹琴
倚栏迎夜月	卷幔挹春风
墙头山水秀	窗外鸟声闲
泉声来枕上	山邑落遵前
兰径香风静	松窗夜月圆
花开香入户	月照影临轩
梅影横窗瘦	松阴覆座凉
开襟坐霄汉	挥手拂云烟
琴清鹤自舞	花笑鸟当歌
闭户莫教风扫地	卷帘疑有月临轩
莫放春秋佳月去	最难风雨故人来
槛外晴峰萦几席	帘前春雨润琴书
好山入座清如洗	嘉树当窗翠欲流
入暮开帘招白鹤	临晨排阁有青山
云拥山光排绣阁	雨催花气入珠帘
自喜轩窗无俗韵	亦知草木有真香
深宵寂寞蟾窥户	清影蹁跹鹤舞轩
直惊喜来三径月	纵横富有百城书
小窗多明俯拾即是	众山倒影乘空欲飞
露引松香来酒盏	雨摧花气入吟笺
碧山人来丰神俊逸	赤城霞举品格高标
前程远大	后步宽宏
生光有道	后福无疆
云路前无限	德门后有余
庭余安乐福	门掩太平居
好留余地	佑启后人
有备无患	虽设常关
积德前程大	存仁后地宏
太平居有后	安乐福无涯
光前振起家声远	裕后留贻世泽长
路从绝处开生面	人到后来看下台
竹径有时风为扫	此门无事日常关
远水碧千里	夕阳红半楼
楼下听春雨	峰多望夏云
元龙有豪气	黄鹤纪游纵
座中千里尽	檐外四山低
江山供指颐	风月助登临
长剑一杯酒	高楼万古心
楼栖沧海月	窗落敬亭云
村拥溪边阁	山浮雨后岚
绣阁珠帘桐掩映	琼楼玉宇自高寒
企谷春深杨柳绿	玉楼人醉杏花红
半榻清风云乍散	一楼明月雨初晴
看山琴入画	爱竹月当楼
千里江山开画本	满湖烟雨入诗情
四面荷花三面柳	一城山色半城湖
千座孤阁抱	万壑一窗含
桃李成蹊径	江山入画图
夜月琴书韵	春风杨柳烟
春去花犹在	人来鸟不惊
数竿修竹三间屋	一席清风万壑云
一亭尽览山中趣	幽室隔绝世外天
林密山深别开三径	花明柳暗又是一村
古调诗吟山色里	弄弦琴在月明中
别墅初栽新竹木	幽居先辟小蓬莱
君子居之别开桂墅	先生归也不隐桃源
风竹引天乐	林亭聚地灵
清风两窗竹	明月一池莲
卷帘花谒人	移座鸟声喧
人居百尺松萝上	诗在千层花雨中
瀑声晴亦语	松潭夏如秋
芳草斜阳外	落花流水间
远望山有色	近听水无声
摇竹一身雨	摘花满手香
蝉噪林愈静	鸟鸣山更幽
鸟爱山中语	琴多弦外音
石榻看云坐	溪窗听雨眠
横琴弹流水	倚槛听鸟音
门对青山含紫气	户盘绿水衍长流
夜案诗香从娥舞	晓窗梦酣任鸡啼
房建福地穷变富	身居乐园锦添花
家居绿水青山畔	人在春风和气中
旭日乍临家室乐	和风初度物华新
画栋连云光旧业	华堂映日耀新居
三阳日照平安宅	五福星临吉庆门
祥云环绕新门第	红日光临喜人家
燕掠琴弦穿静院	竹拂棋子遮闲庭
门迎春夏秋冬福	户纳东西南北祥
红日高照新居户	喜花常开发富家
平安竹种新宅院	富贵花开和睦家
日雨风和锦铺院	冬暖夏爽笑满堂
向阳庭院风光好	勤劳人家幸福多
修竹满庭浮翠色	芳枝绕径映朝晖
门对青山千古看	家居旺地四时新
和平宅吉人昌盛	贤德居安物阜兴
满庭珠矶光旧胄	几车书籍重新近
南檐纳日冬天暖	北户迎风夏夜凉
鱼跃龙门随变化	莺迁乔木喜飞腾
居卜风和仁是里	堂开景聚德为邻
有福有寿勤俭户	无虑无忧康乐家
庆乔迁合家皆禧	居新宅世代永安
丽日楼台花似海	清风杖履客如仙
乔第喜迁新气象	换门不改旧家风
喜延明月长登户	自有春风为扫门
迁居喜逢吉祥日	安宅正遇如意春
四合宅院花馨满	小康人家笑语流
地久天长门有喜	年丰人寿福无边
小宅更新承党恩	合家幸福叙天伦
民重农田能富国	光增新宅喜齐家
人寿宅安居新室	酒香心乐庆乔迁
房后淡烟无墨画	檐前疏雨有声诗
华堂喜对山河秀	福宅常欣日月辉
卜筑流芳先世泽	遗安拥翠绕沙堤
高梧栖凤幸福院	旧柜藏书德贤门
映日门庭增气象	接天梁栋起氤氲
里有仁风春色溥	家余德泽福星临
合家共庆乔迁喜	亲友同享致富欢
择居仁里和为贵	善与人同德有邻
栋拂云霞绕紫气	阁开金屏耀曙色
小舍乐成增吉庆	新居进往集祯祥
惠政得来吉祥地	良工造就福寿堂
新居早迎喷礴日	小院晚挂莲花灯
幸福同沾仁有里	安居新享德为邻
玉树琪花香作锦	水光山色翠连云
气象宣人天坠玉	新家和睦地生金
楼上楼下皆为瑞	门后门前尽呈祥
秀水绕门蓝作带	远山映户翠为屏
山明水秀居吉安	地久天长人祥和
居之安四时吉庆	平为福八节康宁
翠梧久待朝阳凤	玉楼乍起沐花红
院内红梅戏飞雪	门前翠柳舞春风
地灵人杰千祥集	裕后光前百福临
梁栋拂云千年好	门楣映日四季新
日暖阶前生玉树	月明楼上耀华灯
民富齐赞国策好	家昌永怀党恩深
珠帘幕卷西山雨	画栋朝飞南甫云
坎流艮上家人豫	乾转坤旋大有临
倚山背绿添新宇	语燕啼莺入世家
福星高照勤劳宅	喜气长留俭朴实
古槐树下听琴韵	新屋楼头传书声
龙臣当前皆瀚海	凤栖何处不丹山
山桂飘香扬子宅	溪花饶笑杜陵君
秀山青翠青山秀	华夏新建新夏华
玉树繁花景为美	屋华房广人寿年
莺歌燕舞乐金谷	花红柳绿映画堂
翠梧久待朝阳凤	碧树初鸣出谷莺
紫气迎祥双阙晓	彤云献瑞五门春
春柳深处农家乐	白杨水边村舍新
麒麟常怀千里道	凤凰高占一枝语
燕喜新居春正暖	莺迁乔木日初长
门前绿水声声笑	屋后青山步步春
雕梁画栋荫及日月	创家立业福泽子孙
天近彩云连四海	堂开东阁引青阳
瑞彩盈庭出聚秀	祥光当中斗联春
吉日迁居万事如意	良辰安宅百年遂心
创基业门庭祥云卷	展宏图宅第瑞气生
门对青山庭铺芳草	屋临绿水窗放蜡梅
移取春风门栽桃李	蔚成大器材备栋梁
松竹旷怀心神共远	智仁乐雅山水同深
宝气先腾屏开翡翠	玉堂风静帘卷珊瑚
渊岳其心风云入思	圭璋特达鸾骛呈祥
金屋玉堂固称杰构	德门仁里自是安居
其室有兰虚怀若谷	临风兴泳遇水流觞
瑞露凝珠滋润琼圃	祥云焕彩辉映玉霄
乔迁喜天地人共喜	新居荣福禄寿全荣
居之安，宅明日月	人之和，地久天长
惟德成邻莺迁燕喜	以文会友霞蔚云燕
家富人喜顺如流水	时言乐笑穆若清风
率青山华夏迎晓日	吞碧水画栋贺春风
喜落成华构盈门秀色	庆乔迁新居满屋春风
大地欢欣春满华堂	前程广远财来洁室
山河发奇观松茂竹苞涉时秀	庭阶生瑞气兰馨桂馥迁地良
住三楼高览新城因地美	处四邻深结挚友在人和
何段玉宇琼楼方称杰钩	即此德门仁里便是安居
新住房新生活一派新气象	谢戚友谢亲朋合家谢党恩
春华秋实此处饶有农家乐趣	水抱山环其中别具园林风光
华构羡经营创业固宜传后代	芳庭供栖息安居还应颂明时
何须大厦高楼方称舒适	有此青山绿水便好安居
小院一座几度春风几度雨	新房三间半藏农具半藏书
乔木好音多远闻莺迁金谷晓	上林春色早近看花报玉堂开
沣镐圣地天赐风水盖华厦	文哲人家地承栋宇泽长安
勤劳动车劳绩劳动者喜临眉睫	建新房住新居新房主乐在其中
千秋基业勤劳俭朴人为要	四方和气廉贤礼让德行先
山河气象果新奇到处莺歌燕舞	栋宇规模真壮丽满眼虎踞龙蟠
春光入户	燕语垂帘
莺迁乔木	燕舞春风
佳地春风暖	新居燕语喧
仁风春日照	德泽福星明
福临吉地	春满华堂
燕贺新禧	莺歌阳春
户外春风暖	堂前午日长
堂开瑞日金莺啭	帘卷春风玉燕来
燕喜新居迎得春风栽玉树	莺迁乔木蔚成大器建家园
新宅门前一片艳阳芳草地	主人眼下十分春色杏花开
华堂昼永书香满	乔木夜深蛙鼓多
珠帘暮卷西山雨	画栋朝飞南浦云
夏屋新迁莺出谷	华堂彩焕凤栖梧
门对青山千古秀	户迎绿水万年新
槐花落处生瑞气	阳雀啼时入新居
中秋明月拂碧宇	当院紫薇绕朱轩
月满一轮辉宇宙	菊香千里到门庭
黄菊移来三径好	绿杨分作两家春
自喜门窗无俗韵	亦知草本有真香
莺迁乔木松流韵	月洗高秋桂吐香
居之安四时吉庆	平为福八节康宁
岁寒三友添新色	春气满堂聚德光
三阳日照平安地	五福星临吉庆门
冬令如春江山吐秀	生财有道栋宇增辉
